----------------------------
----------------------------
---------E------------------
--S------------Q--?---------
-------S?S------------SSQ---
----------------------------
----------------------------
-SQS------------------------
--------------------SSS--Q--
---------------S------------
-------XX-------------------
------XXX---------<>--------
-----XXXX---E-EE--[]--X-----
---XXXXXXXXXXXXXXXXXXXXXXXXX
