----------------------------
----------------------------
----E-------SQQS------------
--------SSS-----------------
--S?S-----------------------
--------------------?-------
---------------S------------
----------------------------
----------------------------
------------------X---Q-----
------<>----------XX--------
------[]----------XX-----XXX
------[]------E---XX----XXXX
XXXXXXXXXX--XXXXXXXXXXXXXXXX
