----------------------------
----------------------------
-------S?SQ-----SSQS--------
----------------------------
----------------------------
-----------------SSSS-------
----------------------------
---------Q------------------
--S-----------X-------------
--------------XX------------
--------------XXX-----------
-------------XXXX--------<>-
-------X----XXXXX---E----[]-
XX--XXXXXXXXXXXXX-XXXXXXXXXX
