----------------------------
----------------------------
-------------------------S--
------------?------S?SQ-----
----------------------------
----------------------------
----Q------------S---SSSSS--
----------------------------
--------Q-------------------
----------------SQS---------
----------------------------
-----XX------<>--------X----
----XXX------[]--E-----XX---
XXXXXXX--XXXXXXXXXXXX--XXXXX
