----------------------------
----------------------------
------------------Q---------
----------------------------
--S?SQ------SSS-------------
---------?------------------
----------------------------
-------------------S--------
----------------------------
--SSQS----------------------
------------XX--------------
-----------XXX--<>----------
-----X----XXXX--[]----EE-E--
XXXXXXXXXXXXXXXXXXXXXXXXXXXX
