----------------------------
----------------------------
-----------------S-----SS---
---XX-----------------------
--XXX-----------------------
--XXX-----------------------
--XXX-----------------------
--?-#S--SQS---SSSQ----------
----------------------------
----------------------------
-----------<>--Q------------
-----------[]-----------X---
-----------[]----E-EE--XXX--
XX------XXXXXXXXXXXXXXXXXXXX
