----------------------------
----------------------------
----------------------------
----SSS-------SQS-----------
----------S-----------------
----------------------------
----E--?--------------------
-------------Q--------------
--S?S-----------------------
-------X--------------------
-------XX-------<>---XX-----
-------XXX------[]--XXX-----
--EE---XXX------[]-XXXX-----
XXXXXXXXXXXXXXXXXXXXXXX---XX
