----------------------------
----------------------------
---Q------------------------
------S---------------------
----------------------------
------------SSQS------------
----------------------------
-------------------S?SQ-----
-----------SSS--------------
----------------------------
------------------<>--------
---X----XXX-------[]--------
--XX---XXXX-------[]---E-E--
XXXX---XXXXXXX--XXXXXXXXXXXX
