----------------------------
----------------------------
---SSQS---------------------
----------Q-----------------
----------------------------
--?-------------------------
---------------S----SSS-----
----------------------------
----------------------------
--S?SQ----------------------
----------------------------
--------<>---X-----XXXX-----
-----E--[]---XX---XXXXX-----
XXXXXXXXXXX--XXXXXXXXXX--XXX
