----------------------------
----------------------------
---------------------Q------
----------SSQ---------------
--SQS--S--------------------
----------------------------
----------------------------
-------------SSS------------
----------------------------
---------?------------------
----------------XX-----<>---
---------------XXX-----[]---
--E-----------XXXX-----[]---
XXXXXXX--XXXXXXXXXXXXXXXX---
