----------------------------
----------------------------
--------S----------SSQS-----
----------------------------
----------------------------
--Q----------SSS-----S?SQ---
--------?-------------------
----------------------------
------------------X---------
-----------------XX---------
------------<>--XXX---------
------------[]--XXX---------
------E-----[]--XXX---------
XXXXXXXXX-XXXXXXXXXXXXXXXXXX
