----------------------------
----------------------------
--SSS-----------------------
----------Q-----------------
----------------------------
-------?--------------------
----------------------------
------------------SQS-------
-----S?SQ-------------------
----------------------------
--S-------------------XX----
---------X-----------XXX----
-----<>--XX-----E--XXXXX----
XXX--[]--XXXXXXXXXXXXXXX----
