----------------------------
----------------------------
----------------------------
------------------Q---------
--SS------------------------
----------------------------
----------------XX---S------
---------------XXX----------
---------------XXX----------
---SSSQS-------XXX----------
-------------------X--------
------------X-----XX-----<>-
-----EE-----XX---XXX--E--[]-
XXXXXXXXXX--XXXXXXXXXXXXXXXX
