----------------------------
----------------------------
----------------------Q-----
--------S-------------------
-------------SSS------------
----------------------------
----------------------------
--------------------SQS-----
----------------------------
-------<>--------X----------
-------[]-------XX--SSQ-----
-------[]---<>-XXX----------
----E--[]---[]XXXX----------
XXXXXXXXXXXXXXXXXXXXXXXX--XX
