----------------------------
----------------------------
----------------------------
-----------------S----------
----------------------------
--------Q-------------------
----------------------SQS---
------------------?---------
---SSS-------XX-------------
------------XXX-------------
-----------XXXX-------------
----------XXXXX--X----------
----EE-E--XXXXX--XX-----<>--
XXXXXXXXXXXXXXX--XXXXX--[]--
