----------------------------
----------------------------
-------------?---SQ---------
----SSSQS-------------------
----------------------Q-----
----------------------------
----------------------------
----SS---------S-----Q------
----------------------------
----------------------------
--X----------------S--------
XXX------------<>-----XX----
XXX----E-------[]----XXX----
XXX--XXXXXX--XXXXXXXXXXXXXXX
