----------------------------
----------------------------
----------------------------
----------------------------
--------Q-------------------
--------------------SSQS----
----------------------------
----------------------------
-----SQ-----------S---------
--?-------X-----------------
---------XX-----------SSS---
--------XXX----<>-----------
--------XXX----[]--E--------
XXXXXXXXXXXXXXXXXXXXXXXX--XX
