----------------------------
----------------------------
-----------?----------------
----------------------------
------S---------------------
----------------------------
---------------------S?SQS--
----------Q-----------------
----------------------------
---X------------------Q-----
---XX-----SSS---------------
---XXX------------<>----XX--
---XXX---------E--[]---XXX--
---XXX----XXXXXXXXXXXXXXXXXX
