----------------------------
----------------------------
--Q-------------------------
-------------S--------------
----------------------------
------------------SQS-------
----------------------------
--------------SS------------
----------------------------
----X-----------------------
---XX---SSSQ------------<>--
--XXX-------------------[]--
--XXX----------E-E------[]--
XXXXX---XXXXXXXXXXXX--XXXXXX
