----------------------------
----------------------------
--E-------------------------
SSSSSSQS--------------------
----------------------------
-------------------------?--
----------Q-----------------
----------------------------
-------------------S?S--SS--
-------------S--------------
----------------------------
----X----------------XXX----
----XX----<>--------XXXX----
----XXXX--[]----XXXXXXXX--XX
