----------------------------
----------------------------
------E---------------------
---SSSSSSQ-------SQS--------
----------------------------
----------------------------
--Q---------SS--------------
-----?----------------------
---------X------------------
--------XX--------S---------
-------XXX---<>-------------
-------XXX---[]-------------
--X----XXXX--[]--E----------
XXXXXXXXXXXXXXXXXXXXXXXX--XX
