----------------------------
----------------------------
----------------------------
---?------------------------
----------------------------
--------------SSQS----------
---------SSS----------S-----
----------------------------
----------------------------
---------------------X------
---<>-----------Q---XX--XX--
---[]--------------XXX--XX--
---[]--------E-----XXXXXXX--
XXXXXXXXXXXXXXXX---XXXXXXXXX
