----------------------------
----------------------------
--SQS-----------?-----------
---------S?SQ---------------
----------------------------
---------------Q------------
----------------------------
----------------------------
----S----X-----------SSS----
--------XX------------------
-------XXX------------------
-------XXX------------<>----
-------XXX---EE-E-----[]----
XXX--XXXXXXXXXXXXXXXXXXXXXXX
