----------------------------
----------------------------
----?-----------------------
-------SSSQS----------------
----------------------------
----------------------------
------------------Q---------
-----<>---------------------
-----[]--S------------------
-----[]---------------------
-----[]---------------SS----
-----XXX------X-------------
----XXXX-----XX---E---------
----XXXX--XXXXXXXXXXXXX--XXX
