----------------------------
----------------------------
----SSS---------------------
------------------------S---
----------------------------
----------------------------
----------------E-----------
-------------------Q--------
----------<>--S?S-----------
----------[]----------------
---SQS----[]----------------
----------[]---XXX----X-----
--------E-[]--XXXXX--XX-----
XX--XXXXXXXXXXXXXXXXXXX--XXX
