----------------------------
----------------------------
-------SQS-------------SS---
----------------------------
----------------------------
--S-------------------------
------------------------Q---
----------------------------
-----SSSQ----?---X----------
----------------XX----------
---------------XXX----------
---<>----X-----XXX----------
---[]---XX-----XXX----E-EE--
XX-[]--XXX---XXXXXXXXXXXXXXX
