----------------------------
----------------------------
---S?SQQS------?--------Q---
----------------------------
------------S---------------
----------------------------
----SSQ---------------------
---------------------SSS----
----------------------------
----------------------------
-------------------X--------
------X---------XXXX--<>----
------XX--E----XXXXX--[]----
XXXX--XXXXXXXXXXXXXX--[]--XX
