----------------------------
----------------------------
---SQS----------SS---Q------
-------------------------?--
----------------------------
-----------------E----------
----------------------------
---------------S?S----------
----------------------SSS---
----------------------------
--------XX--------<>--------
-------XXX--------[]--------
------XXXX--X-----[]----E---
XXXXXXXXXX--XXXXXXXXXXXXXXXX
