----------------------------
----------------------------
--SQS---------Q-------------
----------------------------
----------------------------
-----SSSQ-------------------
----------------------------
-------------S--------------
---------SSS----------------
----X-----------------------
----XX---------XX-------<>--
----XX--------XXX-------[]--
----XX-------XXXX--E----[]--
XX--XX----XXXXXXXXXXXXXXXXXX
