----------------------------
----------------------------
----SSS---------------------
----------E------SSQS-------
----------------------------
-----S--S?S-----------------
--Q-------------------------
----------------------------
----------------------------
------X---------------------
-----XX---<>-----------?----
----XXX---[]----------------
----XXX---[]---E------------
XX--XXXXXXXX-XXXXXXXXXXX--XX
