----------------------------
----------------------------
--------S?SQ------------?---
-----Q----------------------
----------------------------
--------------SSSQS-----SS--
----------------------------
----------------------------
----------------------------
-----------------S----------
----------------------X---XX
---------------------XX--XXX
-------<>----EE-E---XXX--XXX
XXXXX--[]--XXXXXXXXXXXX--XXX
