----------------------------
----------------------------
-------------?--------------
----------------------------
----------------SQS---------
------------------------Q---
SSS-------------------------
----------------------------
----------------------SSQ---
----------------------------
----XX----------S-----------
---XXX--------------X----<>-
--XXXX-------E------XX---[]X
XXXXXXXXXXXXXXXXX---XXXXXXXX
