----------------------------
----------------------------
----------------------------
----------------------------
---------SSSQS--Q-----------
---SS-----------------------
----------------------------
-----------S----------------
------?-------------S?SQ----
----------------------------
----------------------------
----------X----<>------XX---
--EE-E----XX---[]-----XXX---
XXXXXXXX--XXXXXXXXXXXXXXX---
