----------------------------
----------------------------
--------------?-------------
----Q---------------S-------
----------------------------
----------------------------
-----SSQ--------------------
-------------------S?SQS----
----------------------------
-----X----------------------
----XX------SSS--<>---------
---XXX-----------[]---------
---XXX-----------[]---EE-E--
---XXX-----XXXXXXXXXXXXXXXXX
