----------------------------
----------------------------
-------------------------Q--
------------S-----SSQ-------
---?------------------------
----------------------------
----------------------------
---S-------------S?SQS------
----------------------------
----------SSS----------X----
-----------------------XX---
----------------<>-----XXX--
--E----X--------[]----XXXX--
XXXXXXXXXXXXXX--[]--XXXXXX--
