----------------------------
----------------------------
----SSSQS-------------------
-----------?----------------
---------------SS-----------
----------------------------
-----S------E---------------
------------------Q---------
----------S?S---------------
---------------------X------
---------------------XX-----
---------------------XXXX---
--EE-E--------<>----XXXXX---
XXXXXXXXXXXX--[]--XXXXXXX---
