----------------------------
----------------------------
----------------------------
----------------------------
-----------------------Q----
----------------------------
-----------?--SSSQS---------
----------------------------
----------------------------
-----------S----------------
---SS----------<>-----XX----
---------------[]----XXX----
--------E-E----[]---XXXX----
XXXXXXXXXXXXXXXXXXXXXXXX--XX
