----------------------------
----------------------------
----------S-----------Q-----
----------------------------
-------------S?SQS----------
------SSQ------------?------
----------------------------
----------------------------
----------------------------
---X------------------------
--XX------------------------
XXXX--<>-----------SSS------
XXXX--[]---E-EE-------------
XXXXXXXXXXXXXXXXX------XXXXX
