----------------------------
----------------------------
----------------------------
------------------S---------
---------------Q------------
----------------------------
----SQS----?---------Q------
--------------SSS-----------
----------------------------
---S?SQ---------------------
----------<>-----------XX---
----------[]----------XXX---
----X-----[]---E-----XXXX---
--XXXXXXXXXXXXXXXX--XXXXX---
