----------------------------
----------------------------
-------------Q--------------
--SS------------------------
----------------------------
----------?--S--S?SQQS------
----------------------------
----------------------------
----------------------------
----------------------------
-------------------SSSQ-----
---<>----------X------------
---[]--EE-E---XX------------
XXXXXXXXXXXXXXXX---XXXX--XXX
