----------------------------
----------------------------
----------------------------
----------------SQS---------
-------SSSQ--------------Q--
----------------------E-----
----------------------------
-------SS--------S--S?S-----
----------------------------
-----------X----------------
----------XX-----------<>---
---XX----XXX-----------[]---
--XXX----XXX----EE-E---[]---
XXXXX----XXXXXXXXXXXXXXXXXXX
