----------------------------
----------------------------
---XX----------SSS----------
--XXX---------------Q-------
--XXX-----------------------
--XXX-----------------------
---Q--S-------SSQS----------
----------------------------
----------------------------
--------<>------------------
--------[]---------X--------
--------[]--------XX---<>---
--EE-E--[]-------XXX---[]---
XXXXXXXXXXXXXXXXXXXXXXXXXXXX
