----------------------------
----------------------------
-------------------------?--
-------------------S--------
----------------------------
----------------------------
----------------------------
----------SSS---------------
--SQS-----------------------
----------------Q-----------
--------XX--------------<>--
-------XXX--------------[]--
------XXXX-------E-EE---[]--
--XXXXXXXXXXXXXXXXXXXXXXXXXX
