----------------------------
----------------------------
----S--------SSS------------
-------SQS------------------
---------------------S?SQ---
------------?---------------
---------S------------------
----------------------------
------------Q---------------
----------------------------
--------------------XX------
-----------X----<>-XXX------
----E-E----XX---[]XXXX------
XXXXXXXXX--XXXXXXXXXXX---XXX
