----------------------------
----------------------------
----------------------------
--------------S?SQ----------
----------------------------
-----SSSQS------------------
----------------------------
----------------------------
-----S-----Q-------SS-------
----------------?--------X--
------------------------XX--
------------<>---------XXX--
------E-EE--[]--------XXXX--
XXXXXXXXXXXXXXXXX--XXXXXXXXX
