----------------------------
----------------------------
----------------------------
-------SSS-----E------------
-------------SSSSSQS--------
----------------------------
----------------------------
----------------------------
---S------------------------
----------Q-----------------
-------------------XX---<>--
------------------XXX---[]--
----X--EE-E------XXXX---[]--
XXXXXXXXXXXXXX---XXXX--XXXXX
