----------------------------
----------------------------
----------Q-----------------
----------------------------
---------------------S?SQS--
----------------------------
---SSS----------------------
----------------------------
----------------------------
----------------S-------X---
-----------------------XX---
-------<>-------------XXX---
-------[]----------E--XXX---
XX---XXXXXXXXXXXXXXXXXXXXXXX
