----------------------------
----------------------------
----------------------------
---S?SQ---------------------
----------------------------
-----------------Q----------
-----SSSQS-----------SS-----
-------------S--------------
----------------------------
----------------------------
-----------XX---------------
----------XXX--<>-----------
----X----XXXX--[]--E-EE-----
XXXXXXXXXXXXXXXXXXXXXXXXXXXX
