----------------------------
----------------------------
-------------------?--------
----------------------------
----------------------------
------S?SQS------------SSS--
---------------SSQ----------
----------------------------
---------Q------------------
----------------------------
------------X---------------
------<>----XXX------XX-----
------[]----XXX-----XXXX--E-
XX--XXXXXXXXXXX-----XXXXXXXX
