----------------------------
----------------------------
----------------------------
----------------------------
------------SS--------------
----------------------------
----------------------------
------------Q---------------
-----------------------S----
---SSSQS--------------------
-----------XX---------------
----------XXX--------X------
------<>--XXX--E-E--XX------
XXXX--[]--XXXXXXXXXXXX----XX
