----------------------------
----------------------------
-------Q--------------------
----------------------------
---------------------SSSQS--
--Q----------SS-------------
------?---------------------
----------S-----------------
----------------------------
--------------------X-------
--------------------XX------
---------<>----XX---XXX-----
--E------[]---XXX---XXXX----
XXXXXXXXXXXXXXXXX---XXXXXX--
