----------------------------
----------------------------
------------------?---------
---SSQS---------------------
----------------------------
----------------------------
------------S?SQ------------
--------------------SSS-----
----------------------------
------Q-----X---------------
-----------XX------S--------
---X------XXX---------------
---XX----XXXX----------E----
---XXXXXXXXXX--XXXX--XXXXX--
