----------------------------
----------------------------
----------------------------
---------------S?SQ---------
----------------------------
----SS---------------------S
-----------S----------------
-----------------------?----
----------------------------
----SSSQS----------Q--------
--------------X-------------
--------------XXX-----X-----
--E------<>---XXXX---XX-----
XXXXXXX--[]---XXXXXXXXX--XXX
