----------------------------
----------------------------
--------------?-------Q-----
----------------------------
----------------------------
--SSQS----------------------
----------------------------
----------------------------
--------SSS-----------------
--S-------------------------
----------------------------
-------XX---X--------<>-----
------XXX---XX---E---[]-----
XXXXXXXXX---XXXXXXXXXXXXXXXX
