----------------------------
----------------------------
----------------------SSQ---
--?-------------------------
---------------SSS----------
----------------------------
----------------------------
---------S?SQQS---Q------S--
----------------------------
----X-----------------------
----XX------------X---<>----
----XXX----------XX---[]----
----XXXX--E-----XXX---[]----
XXXXXXXXXXXXXXXXXXX---[]--XX
