----------------------------
----------------------------
----------------------------
--------S--------------?----
----------------------------
-----------S?SQS------------
----------------------------
---Q------------------------
------SQ----------SSS-------
------------------------<>--
------------------------[]--
------XXX-------X-------[]--
--E--XXXX-------XX------[]--
XXXXXXXXX--XXX--XXXXXXXXXXXX
