----------------------------
----------------------------
-------S--------------------
----------------------SSQS--
----------------------------
----------------------------
------S?SQ-----------SSS----
----------------------------
----------------------------
------------------------?---
----------XX----------------
----<>---XXX----Q----X------
----[]--XXXX---------XX--E--
XXX-XXXXXXXX---------XXXXXXX
