----------------------------
----------------------------
-----SSS---S----------------
---------------Q------------
----------------------------
----------------------------
-----------------SQS--------
----E-----?-----------------
----------------------------
--S?S-------------SSQ-------
--------<>----XX------------
--------[]---XXX------------
----E---[]--XXXX------------
--XXXXXXXXXXXXXXXXXXXXXXXXXX
