----------------------------
----------------------------
-------------S?SQS----------
------SSQ-------------------
----------------------------
-------------------------S--
---------?------------------
----------------------------
----------------Q-----------
-----------SSS--------------
---XX----------------XX-----
---XX---------------XXXX----
---XX----<>----E---XXXXXX---
XXXXX----[]--XXXXXXXXXXXXXXX
