----------------------------
----------------------------
---------Q------------------
------------SQS-------------
----------------------------
---SSS---E------------------
----------------------------
-------S?S----------S-------
----------------------------
----------------------------
--------?--X----------------
----XXX----XX-------<>------
---XXXX----XXX---E--[]------
XXXXXXX----XXXXXXXXXXXXXXXXX
