----------------------------
----------------------------
-------SSQ----Q-------------
--------------------SSS-----
----------------------------
----------------------------
----------------------------
-------S?SQS-----S----------
----------------------------
---XX-----------------------
--XXX-----------------------
--XXX----X------<>----------
--XXX----XX-----[]--E-------
XXXXX----XXXXXXXXXXXXXXXXX--
