----------------------------
----------------------------
--------------S-------------
-------------------S?SQS----
--SSSQ----------------------
--------?---SS--------------
-----------------------Q----
----------------------------
----------------------------
----------------------------
---Q------------------------
--------<>--------X----XXX--
--------[]----E--XX---XXXX--
XXXXX---[]--XXXXXXX---XXXX--
