----------------------------
----------------------------
----S---Q--------SSQ--------
----------------------------
----------------------------
-------------SQS----S-------
-------?--------------------
----------------------------
-------------Q--------------
------X------------SSS------
-----XX---------------------
----XXX----------------<>---
---XXXX--E-E-----------[]---
XXXXXXXXXXXXXXX-----XXXXXXX-
