----------------------------
----------------------------
----------------------------
---SS-----------------------
----------Q-----------------
----------------------S?SQS-
----------------Q-----------
-----S----------------------
----------------------------
----------------------------
------------?--SSSQ-----<>--
------XXX---------------[]--
--E--XXXX------------X--[]--
XXXXXXXXX--XXXXXXX---XXXXXXX
