----------------------------
----------------------------
-----------Q----------------
-------------------------E--
----------------------------
-------SSSQS-----------S?S--
----------------------------
----------------------------
----------------------------
-----------X------------SS--
----------XX----------------
---------XXX-------<>-------
---XX----XXX--E-E--[]-------
XXXXX----XXXXXXXXXXXXXXXXX--
