----------------------------
----------------------------
SSSS--------Q---------------
----------------S----S------
---------Q------------------
---Q------------------------
------?---------------------
-----------SSQ--SQS---------
----------------------------
---S------------------------
------------XX--------------
-------<>--XXX--------X-----
----E--[]--XXX-------XXX----
XXXXXXXXXXXXXXXXXXXXXXXXXXXX
