----------------------------
----------------------------
------------------SQ--------
----------------------------
-------Q--------------------
------------------E---------
----------------SSSSSS------
----------SSQS--------------
----------------------------
-----------------X----------
---<>-----------XX----------
---[]----------XXX----------
---[]--EE-E---XXXX----------
XXXXXXXXXXXXXXXXXXXXX----XXX
