----------------------------
----------------------------
----------------------------
--------?---SSS-------------
----------------------------
----------------------------
--------------Q-------------
----------------------------
----------------------------
--SQS--------------X--S-----
------------S?SQ--XX--------
-------X---------XXX--------
--<>---XX--------XXX--E-----
--[]---XXXXXXXX--XXXXXXXXXXX
