----------------------------
----------------------------
----------------------------
--S-----------------S?S-----
----------------------------
----------SSQS--------------
-------------------------?--
----------------------------
----------SSS---------------
---SQ---------------Q-------
----------------------------
--------XXX---X-------------
-------XXXX---XX---E--EE----
XXXX--XXXXX---XXXXXXXXXXXXXX
