----------------------------
----------------------------
----------------------------
-----------SSS--------------
-----------------------?----
----------------------------
-------------S--------------
------Q-----------E---------
----------------------------
----------X-----S?S---------
----SQS---XX----------------
----------XXX-----------<>--
---------XXXX------E-E--[]--
XXXXXXXXXXXXX----XXXXXXXXXXX
