----------------------------
----------------------------
---------------Q------------
---SSS----SQ----------------
----------------------------
--------------S-------------
----------------------------
----------------------------
-------------SSQS-----------
----------------------------
--------?----------------XX-
---------------<>----X--XXX-
------------E--[]X--XX--XXX-
XXXX---XXXXXXXXXXXXXXX--XXX-
