----------------------------
----------------------------
----------------------------
-----S?SQ-------------------
-------------S--------SQS---
----------------------------
----------------------------
----------------------------
----------------------------
----<>-----SSS--------------
----[]--Q--------XX---------
----[]----------XXX---------
----[]------E--XXXX---------
XXXXXXXXXXXXXXXXXXXXXXXX----
