----------------------------
----------------------------
---------------------?------
----------------------------
--------S?SQ----------------
----------------------------
-------------------------S--
--------SS---SSSQS----------
----------------------------
----------------------------
------------<>------Q-------
------------[]-----------XXX
--E-EE------[]----------XXXX
XXXXXXXXXXXXXXXXXXX--XXXXXXX
