----------------------------
----------------------------
---------SSS----------------
----------------------------
---Q-------------------SQS--
-------?--------------------
---------------S------------
----------------------------
---<>-----------------------
---[]-----------------------
---[]--X--------------------
--XXX--XX-------------------
-XXXX--XXX--------EE-E------
XXXXX--XXXXXXXXXXXXXXXXXXX--
