----------------------------
----------------------------
-------SSSQS-----------S----
----------------------------
----------------------------
---------E----------SQ------
------------SS--------------
-------S?S------------------
----------------------Q-----
---X---------------------?--
---XX-----------------------
---XXXX-------X---<>--------
---XXXX------XXX--[]--E-----
---XXXX----XXXXXXXXXXXXXXXXX
