----------------------------
----------------------------
--------------S-------------
--?--Q----------------------
----------------------------
---------------SSS----------
-----SSQ---------------SQS--
------------Q---------------
----------------------------
----------------------------
-------XX-------------------
------XXX-----<>------------
-----XXXX-----[]--E---------
XXXXXXXXXXXXXXXXXXXXX--XXXXX
