----------------------------
----------------------------
----SS--------SSSQQS----E---
----------------------------
----------------------S?S---
----------------------------
----------------?-----------
----------------------------
----------------------------
--------------------Q-------
-----------S----------------
----<>----------X------XXX--
----[]----------XX----XXXX--
XXXXXX-----XXX--XXXXXXXXXX--
