----------------------------
----------------------------
----------------------------
----------------------------
---?------------------------
--------SSQS-------S?SQ-----
----------------------------
---------------Q------------
----------------------------
---------S--------SSS-------
------X--------<>-----------
-----XX--------[]-----------
----XXX--------[]--EE-E-----
XXXXXXX--XXXXXXXXXXXXXXXX---
