----------------------------
----------------------------
----------------------------
--------SSS-----------------
--S-------------------------
-------------E--------------
----------------------------
-----------S?S--------------
-------X--------<>----------
------XX--------[]----SQS---
-----XXX-----Q--[]----------
----XXXX--------[]----------
---XXXXXX-------[]----EE-E--
XXXXXXXXXXX--XXXXXXXXXXXXXXX
