----------------------------
----------------------------
--S-------------------------
----------------------------
-----------------------?----
--Q-------------------------
----------------SQS---------
------SS--------------------
----------------------------
-----------------SSSQ-------
---<>--------------------XX-
---[]------X------------XXX-
---[]------XX----EE-E--XXXX-
XXXXXXXXX--XXXXXXXXXXXXXXXX-
