----------------------------
----------------------------
-----------S?SQ-------------
----------------------------
----------------------?-----
----Q-----------------------
----------------------------
-------------------------SSS
----SS-------SQS------------
----------------------------
--------------------X-------
--XX----<>--------XXX-------
-XXXX---[]--E-----XXX-------
XXXXXXXXXXXXXXXXXXXXX--XXXXX
