----------------------------
----------------------------
---------SQS----------------
----S-----------------------
-------------------------?--
----------------------------
-----Q---SSS----------------
----------------------------
----------------------------
----S?SQ--------------------
-----------<>---XX----------
-----------[]--XXX------X---
--E----EE--[]--XXX------XX--
XXXXXXXXXXXXXXXXXXXXXX--XXXX
