----------------------------
----------------------------
-------------SSSQS----------
----------------------------
?SQQS-----------------------
----------------------------
---------------Q------------
----------------------------
----------------------------
----------------SS----------
----------XX----------------
---------XXX----------S-X---
-----E--XXXX------<>----XX--
XXXXXXXXXXXX--XX--[]----XXXX
