----------------------------
----------------------------
----S-----------------------
-----------S?SQ-------SSS---
------------------Q---------
----------------------------
----------------------------
---------------SSQS---------
----------------------------
-----------X----------------
--------X--XX-------<>------
-------XX--XXX------[]------
-----XXXX--XXX---E--[]------
XXXXXXXXX--XXXXXXXXXXXXXXX--
