----------------------------
----------------------------
-------------?--------------
----------------------------
----------------------------
----------------S?SQ--------
------------------------S---
----------SSS---------------
--SQS-----------------------
----------------------Q-----
----------------------------
---XXX-----------X-------X--
--XXXX------<>---XX--E--XX--
XXXXXXXXXX--[]---XXXXXXXXX--
