----------------------------
----------------------------
---------S?SQS--------------
-----S----------------------
----------------------------
--------------Q-------------
----------------------?-----
----------------------------
-------------SSS------------
----------------------------
-----<>-----------XX--------
-----[]----------XXX--------
-----[]---X-----XXXX--E-E---
XXXXXXXXXXXXXXXXXXXXXXXXXXXX
