----------------------------
----------------------------
----------------------------
----------------------------
----------------------------
--------------------SSS-----
------Q---------------------
---S-----SSQS---------------
----------------------------
----------------------------
---XX-----------------------
--XXX-------------------<>--
--XXX-------EE-E-E---X--[]--
XXXXXXXXXXXXXXXXXXXXXXXXXXXX
