----------------------------
----------------------------
----?-----------------------
----------------------------
----------------------------
--------------------SSQS----
--------------S?SQ----------
-------------------------Q--
--S-------------------------
----------------------------
----------------SSS----X----
----<>----------------XX----
----[]---E-----------XXX----
XXXXXXXXXXXXXXX----XXXXX--XX
