----------------------------
----------------------------
-----------------------SSQ--
----------------------------
----------------------------
----------------------------
----------------------SSS---
--S?SQS---------------------
----------------------------
---------Q------------S-----
----------------------------
-----X------XXX-----------<>
-----XX----XXXX----E-EE---[]
XXX--XXXXXXXXXX--XXXXXXXXXXX
