----------------------------
----------------------------
------------SSS----SSQS-----
----------------------------
---------XX-----------------
--------XXX-----------------
--------XXX------------?----
--------XXX-----------------
--------------Q-------------
------S---------------------
----------------------------
---X------<>----------------
--XXX-----[]-----E----------
XXXXXXXXXXXXXXXXXXXXX---XXXX
