----------------------------
----------------------------
----------------------------
----------------------------
----------------------------
-----------Q-------SSS------
----S-----------X-----------
----------------XX----------
----------------XXX----Q----
---S?SQS--SSQ---XXXX--------
----------------XXXX--------
---------------XXXXX--<>----
---E----------XXXXXX--[]----
XXXXXXX---XX--XXXXXXXXXXXXXX
