----------------------------
----------------------------
----SSS---Q--------------?--
----------------------------
----------------------------
---------S---SSQS-----------
------------------------Q---
----------------------------
----------------------------
----------------------------
--X-------------------------
--XX-----XX-----------<>----
--XXX---XXX-----E-----[]----
XXXXXXXXXXXXXXXXXXXX--[]--XX
