----------------------------
----------------------------
----------------------------
-----------------------S----
------Q---------SSSQ--------
----------------------------
----------------------------
---------SQS----------------
---------------?------------
-----Q--------------SS------
-----------X----------------
----------XXX-----------<>--
---------XXXXX---E-EE---[]--
XXXX---XXXXXXXXXXXXXXXXXXXXX
