----------------------------
----------------------------
----E-----------------------
----------------------------
--S?S-----------------Q-----
----------------------------
------------SSSSQS----------
--------------------SS------
----------------------------
--SQ------------------------
-----------XX----<>---------
----------XXX----[]---------
-----X----XXX----[]-E-EE----
XXXXXXXXXXXXX--XXXXXXXXXXX--
