----------------------------
----------------------------
---------Q--SSQS------------
----------------------------
----------------------------
----SSS---------S-----------
----------------------------
---------------------XX-----
--------------------XXX-----
-----<>--------E----XXX-----
-----[]------SSSSS--XXX-----
XX---[]------------------X--
XXX--[]--------------E--XX--
XXXXXXXXXX----XXXXXXXXXXXXXX
