----------------------------
----------------------------
-----Q------------SSQQS-----
----------------------------
----------------------------
-----------------------SSS--
-----Q----------------------
--------?------------X------
----------------S----XX-----
---------------------XX-----
------S?SQ-----------XX-----
------------<>------XXX-----
------------[]-----XXXX--E--
---XXXXXXXXXXXXXX--XXXXXXXXX
