----------------------------
----------------------------
--------SSSSQS--------------
----------------------------
----------------------------
----------?-----------------
---------------SS--S--------
----------------------Q-----
----------------------------
----------------------------
------------------------<>--
-----X---------XXX------[]--
-----XX--E----XXXX------[]--
XXX--XXXXXXXXXXXXX--XXXXX]XX
