----------------------------
----------------------------
----------------------------
----------------------------
--S--------------?----------
----------------------------
----------SSS---------------
-------------------------Q--
----------------------------
----------SSQS---S?SQQS-----
------X------------------Q--
-----XXX--------------------
----XXXX------E-E-----------
XXXXXXXX--XXXXXXXXX-----XXXX
