----------------------------
----------------------------
-----S?SQS------------------
---------------------Q------
----------------------------
----------------------------
----------------------------
---SSSQ-----------------S---
----------------------------
----------------------------
---SS------<>-----------XX--
-----------[]----------XXX--
-------EE--[]--X--E---XXXX--
XXXXXXXXXXXXXXXXXXXXXXXXXXXX
