----------------------------
----------------------------
--?------------Q------------
----------------------------
-------------------------S--
----------------------------
--------S?SQS--SSS----------
----------------------------
---------------------X------
--------------------XX------
---------<>--------XXX------
---------[]--------XXX------
--X---E--[]--------XXX------
XXXXXXXXXXXXXX--XXXXXXXXXXXX
