----------------------------
----------------------------
----------------------------
----------------------------
----------------------------
------------------SSSSQS----
----------------------------
----------------------------
----S---------Q-------------
-------------------SS-------
----------------------------
-----------------------<>---
----E---X--------------[]---
XXXXXXXXXXXXX---XXXXXXXXXXXX
