----------------------------
----------------------------
----------------------------
--------Q-----SSSSQS--------
---SS-----------------------
----------------------------
----------------------------
----------------------------
----------------------------
-----S---------<>-----------
---------------[]-----------
---------------[]-----------
---------X-----[]----E-E----
XX---XXXXXXXXXXXXXXXXXXXXXXX
