----------------------------
----------------------------
----------------------------
----------------------------
------------------SSSS------
--------Q-------------------
---S------------------------
----------------------------
----------------------------
-------------------<>-------
-------------------[]-------
-------------------[]-------
---------------E-E-[]---E---
XXXX---XXXXXXXXXXXXXXXXXXXXX
