----------------------------
----------------------------
----------------------------
-------SSSS-----------------
----------------------------
----------------------------
---S------------------------
----------------------------
-----------------Q----------
----------------------------
----------------------------
----------------------------
------X---E--------<>-------
---XXXXXXXXXXXXX---[]---XXXX
