----------------------------
----------------------------
----------------------------
--------S-------------------
---SS-----------SSSSQS------
----------------------------
----------------------------
-----------Q----------------
----------------------------
----------------------------
----------------------------
-------<>-------------------
-------[]-------X----EE-E---
---XXXXXXXXXXXXXXXXXXXXXXXXX
