----------------------------
----------------------------
----------------------------
------------------------S---
----SSSS------Q-------------
----------------------------
----------------------------
----------------------------
----------------------------
----------------------------
-------------X--------------
-----<>-----XXX-------------
-----[]----XXXXX-----E------
XXXXXXXXXXXXXXXXXXXXXXXXX---
