----------------------------
----------------------------
----------------------------
-----Q----------------------
-----------?----------------
--------------------SS------
----------------------------
------S---------------------
----------SSSSQS------------
----------------------------
------------------------XX--
-----------------------XXX--
------<>--------E-E---XXXX--
-XX---[]---XXXXXXXXXXXXXXX--
