----------------------------
----------------------------
----------------------------
----------------------------
-----S--------SSQS----------
----------Q-----------------
----------------------------
----------------------------
----------------------------
------SSSS-----------<>-----
---------------------[]-----
---------------------[]-----
-------------X---E---[]-----
XXXXXXX---XXXXXXXXXXXXXXXXXX
