----------------------------
----------------------------
----------------------------
-------------Q--------------
-------S--------------------
----------------------------
-----------------SSQS-------
----------------------------
----------------------------
--------SSSS----------------
----------------------------
-----------------------<>---
----E-------------X----[]---
XXXXXXXXXXXX--XXXXXXXXXXXXXX
