----------------------------
----------------------------
----------------------------
-------SSQS-----------------
--------------------S-------
----------------------------
----------------------------
----------------------------
------SSSS------------------
--------------------Q-------
-------------------------XX-
---------------<>-------XXX-
----------E----[]------XXXX-
XXXX---XXXXXXXXXXXXXXXXXXXXX
