----------------------------
----------------------------
----------------------------
----------SSQS---------S----
----------------------------
----------------------------
----------------------------
-------Q--------SSSS--------
----------------------------
----------------------------
----------------------------
------------------------<>--
------------X-----E-E---[]--
XXXXX--XXXXXXXXXXXXXXXXXXXXX
