----------------------------
----------------------------
----------------------------
------SS----Q---------------
----------------------------
----------------SSSQS---S---
----------------------------
----------------------------
----------------------------
-------------------<>-------
-----------XX------[]-------
----------XXX------[]-------
---E-E---XXXX------[]-------
XXXXXXXXXXXXXXXXXXXXXXXXX---
