----------------------------
----------------------------
----------------------------
------------SSSSQS----------
------SS--------------------
----------------------------
----------------------------
-----------S----------Q-----
----------------------------
----------------------------
----------------------------
-------------------<>-------
----X---E-E--------[]-------
XXXXXXXXXXXXXXXX---[]---XXXX
