----------------------------
----------------------------
----------------------------
----------------------------
----------------------------
----------------------------
----------------------------
------Q---------SSSS--------
------------------------S---
----------------------------
----------------------------
---------------<>-----------
------X----E---[]-----------
XXXXXXXXXXXXXXXXXXXXX---XXXX
