----------------------------
----------------------------
----------------------------
---Q------------------------
--------SSS-----------------
---------------S------------
----------------------------
----------------------------
----------------------------
--------<>------------------
--------[]------------XX----
--------[]-----------XXX----
--------[]---E-E----XXXX----
XXXXX--XX-XXXXXXXXXXXXXX---X
