----------------------------
----------------------------
----------------------------
----------------------------
---SS-----------------------
-------------Q--------------
--------S----------SSSSQS---
----------------------------
----------------------------
----------------------------
------<>-------XX-----------
------[]------XXX-----------
------[]-----XXXX------E----
XXX---[]---XXXXXXXXXXXXXXXXX
