----------------------------
----------------------------
----------------------------
----------------------------
-------------Q--------------
----------------------------
------------------S---SSS---
----------------------------
-------SSQS-----------------
----------------------------
-------------------<>-------
-------------------[]-------
----X----E---------[]-------
XXXXXXXXXXXXX---XXXXXXXXXXXX
