----------------------------
----------------------------
----------------------------
----------------------------
---S-----------SSSS---Q-----
----------------------------
-------SSQS-----------------
----------------------------
----------------------------
----------------------------
----------------------------
------------<>--------------
-----E------[]--------------
XXXXXXXXX---[]---X--XXXXXXXX
