----------------------------
----------------------------
----------------------------
---------------------S------
-------SSQS-----------------
----------------------------
----------------------------
---Q------------------------
---------------------SSSS---
----------------------------
----------------------------
------------<>--------------
------------[]-----X---E----
XXXXXX--XXXXXXXXXXXXXXXXXXXX
