----------------------------
----------------------------
----------------------------
-------------Q--------------
----------------------------
-----S----------------------
----------------------------
----------SSSS--------------
----------------------------
-----<>-----------?---------
-----[]---------------------
-----[]------XX-------------
-----[]-----XXX---------E---
XXXXXXXXXXXXXXX---XXXXXXXXXX
