----------------------------
----------------------------
----------------------------
----------------------------
---------SSSS---------------
----------------------------
----------------------------
---S------------------------
-----------------Q----------
-------------X--------------
------------XX--------------
--------<>-XXX--------------
--------[]XXXX---X----E-E---
XXXXXXXXXXXXXXXXXXXXXXXXXXXX
