----------------------------
----------------------------
----------------------------
----------------------------
----SSSS--------------------
----------------------------
-----------Q---SSQS---------
----------------------------
----------------------S-----
----------------------------
----------------XX----------
-----<>--------XXX----------
-----[]---X---XXXX---E------
-XXXXXXXXXXXXXXXXXXXXXXXXXX-
