----------------------------
----------------------------
----------------------------
----------------------------
----------------------Q-----
------SS---SSSSQS-----------
----------------------------
----------------------------
----------------------------
----------S-----------------
-----------------------XX---
-----<>---------------XXX---
-----[]------E-E-----XXXX---
XXXXXXXXXXXXXXXXXXXXXXXXXXXX
