----------------------------
----------------------------
----------------------------
-----Q----------------------
---------------------SSQS---
----------------------------
----------------------------
--------------SSSS----------
----S-----------------------
----------------------------
--------X-------------------
-------XXX----<>------------
------XXXXX---[]------E-----
XXXXXXXXXXXXXXXXXXXXXXXXXXXX
