----------------------------
----------------------------
----------------------------
-----Q-----SSQS-------------
----------------------------
----------------------------
----------------------S-----
------------SSSS------------
----------------------------
----------------------------
----------------------------
------------------<>--------
E-----------------[]----E-E-
XXXXXXXX---XXXXXXXXXXXXXXXXX
