----------------------------
----------------------------
----------------------------
----------------------------
------SSSS---------SSQS-----
----------------------------
----------------------------
----------------------------
---------Q------S-----------
----------------------------
----------------------------
----------------------------
------E-E---------<>--------
XXXXXXXXXXXXXXX---[]---XXXXX
