----------------------------
----------------------------
----------------------------
----------------------------
------S---------------------
----------------------------
----------------------------
----------------------------
----------Q---------SSSS----
----------------------------
----------------------------
---------------<>-----------
----E-E--------[]-------X---
XXXXXXXXXXXX---[]---XXXXXXXX
