----------------------------
----------------------------
----------------------------
---SSSQS--------------------
--------------------Q-------
-----------SS---------------
------------------------S---
----------------------------
-------------------?--------
----------------------------
----------X---<>------------
---------XX---[]------------
--------XXX---[]------E-----
XXXX--XXXXX---[]---XXXXXXXXX
