----------------------------
----------------------------
----------------------------
-----SSSS------SSQS---------
----------------------------
----------------------------
----------------------------
----------S----------Q------
----------------------------
----------------------------
----XX----------------------
---XXX-----------------<>---
--XXXX------E-E--------[]---
XXXXXXXXXXXXXXXXXXX----[]---
