----------------------------
----------------------------
----------------------------
----------------------SSS---
----------------------------
------------------?---------
------------S---------------
----------------------------
------Q---------------------
------------------<>--------
------------------[]--------
------------------[]--------
-----E-------EE-E-[]---X----
XXXXXXXXXXXXXXXXXXXXXXXXXXXX
