----------------------------
----------------------------
----------------------------
---SSSS---------------------
----------------------------
----------------------------
----------Q-----------------
----------------------------
----X-------------------S---
---XX-----------------------
--XXX-----------------------
XXXXX-----------<>----------
XXXXX-----------[]---E-E----
XXXXXXXX--XXXXXXXXXXXXXXXXXX
