----------------------------
----------------------------
----------------------------
----------------------------
-----SSSS-------------------
-----------------Q----------
----------------------------
----------------------------
----------------------------
---------------<>---S-------
---------------[]-----------
---------------[]-----------
----E-E----X---[]---------E-
-XXXXXXXXXXXXXXXXXXX--XXXXXX
