----------------------------
----------------------------
----------------------------
-----SSSQS------------------
----------------------------
-------------Q--------SS----
----------------------------
--------?-------------------
---S------------------------
----------------------------
--------------------<>------
--------------------[]------
------E-------------[]------
---XXXXXXXXXXX--X---[]---XXX
