----------------------------
----------------------------
----------------------------
----------SS----------------
----------------------------
------S---------------------
------------------SSSSSQS---
-----------Q----------------
----------------------------
----------------------------
----------------------------
---------------<>-----------
-----X---------[]---E-------
XXXXXXXXX--XXXXXXXXXXXXXX---
