----------------------------
----------------------------
----------------------------
-------Q--------------------
----------------------------
-----------------------?----
------------S---SSSS--------
----------------------------
----------------------------
----------------------------
------------------------XX--
----------<>-----------XXX--
---E------[]------X---XXXX--
XXXXXXXXXXXXXXXXXXXXXXXXXX--
