----------------------------
----------------------------
----------------------------
----------------------------
------SSSSS-----------------
----------------------------
-----------------------S----
----------------------------
----------------------------
--------Q-------------------
----------------------------
--------------<>------------
--------------[]---E--------
XXXXXX---XXXXXXXXXXXXXXXX---
