----------------------------
----------------------------
----------------------------
----------?-----------------
------S-------------SSSS----
----------------------------
----------------------------
----------------------------
---------------------Q------
----------------------------
-----------------<>---------
-----------------[]---------
------E----------[]-E-------
XXXXXXXXXX---XXXXXXXXXXXXXXX
