----------------------------
----------------------------
----------------------------
----------------------------
----------------------------
---------------Q-----SSSS---
----------------------------
----------------------------
----------------------------
----------------S-----------
----------------------------
----------------------<>----
------E-E-------------[]----
XXXXXXXXXXXXXXX----XXXXXXXXX
