----------------------------
----------------------------
----------------------------
------Q---------------------
----------------------------
----------------------------
----------------------------
-----------------------SS---
-----S----------------------
------------------<>--------
-----------XX-----[]--------
----------XXX-----[]--------
---E-E---XXXX-----[]--------
XXXXXXXXXXXXXXXXXXXXXXXXXXXX
