----------------------------
----------------------------
----------------------------
----------------------------
---Q------------------------
-------------------SS-------
----------------------------
----------------------------
------------------------S---
-----SSSQS------------------
---------------<>-----------
---------------[]-----------
---------------[]-----------
XXXXXXXX--X----[]---XXX--XXX
