----------------------------
----------------------------
----------------------------
--------------------SSSS----
----------------------------
----------------------------
------------S---------------
----------------------------
--------Q-------------------
----------------------------
----------------------------
---------------<>-----------
---------------[]----E-E----
XXXXXXX---XXXXXXXXXXXXXXXXX-
