----------------------------
----------------------------
----------------------------
------?---SS----------------
-------------------S--------
----------------------------
----------------------------
---SSSSQS-------------------
----------------------------
--------------Q-------------
----------------------------
-----------------------<>---
---X------E------------[]---
XXXXXXXXXXXXXXXX--XX---[]---
