----------------------------
----------------------------
----------------------------
----------------------------
-----Q-----------------SS---
----------------------------
----------------------------
----------------------------
SSSQS--------------?----S---
--------<>------------------
--------[]------------------
--------[]------------------
--------[]----------EE-E----
XXXXXX---?----XXXXXXXXXXXXXX
