----------------------------
----------------------------
----------------------------
----------------------------
----SS-----------SSSSQS-----
----------------------------
----------------------------
----------------------------
--------Q---------------S---
----------------------------
----------------------------
-------------------<>-------
---E----------X----[]-------
XXXXXXXXX--XXXXXXXXXXXXXXXXX
