----------------------------
----------------------------
----------------------------
---SS-----------------------
--------SSSSQS--------------
----------------------------
----------------------------
----------------------------
------------Q---------------
----------------------S-----
------<>--------------------
------[]--------------------
------[]-E-E------X---------
XXXXXXXXXXXXXXXXXXXXXXX--XXX
