----------------------------
----------------------------
----------------------------
---SSSS----Q----------------
----------------------------
------------------S---------
----------------------------
----------------------------
----------------------------
----------------------------
-------------XX-------------
------------XXX---<>--------
---E-E-----XXXX---[]--------
XXXXXXXXXXXXXXXXXXXXXXXXX---
