----------------------------
----------------------------
----------------------------
------------------SSQS------
----------------------------
----------------------------
---S------------------------
------------------------Q---
----------------SSSS--------
-----------?----------------
----------------------------
----<>----------------------
----[]----------EE----------
XXXXXXXXX----XXXXXXXX--XXXXX
