----------------------------
----------------------------
----------------------------
----------S----------SSQS---
----------------------------
------Q---------------------
----------------------------
---------------------SSSS---
----------------------------
----------------------------
-----<>---------------------
-----[]---------------------
-----[]----------E-E----X---
XXX--[]---XXXXXXXXXXXXXXXXXX
