----------------------------
----------------------------
----------------------------
----------------------------
--------------SSSS----------
----S-----------------------
---------------------Q------
----------------------------
----------------------------
----------------------------
----------------------------
--------------------<>------
----E-E---X---------[]------
XXXXXXXXXXXXXX--XXXXXXXXXXXX
