----------------------------
----------------------------
----------------------------
----------------------------
----------------------Q-----
-----SSQS---S---------------
----------------------------
----------------------------
-----------------SSSS-------
----------------------------
------XX--------------------
-----XXX--------------<>----
----XXXX------EE-E----[]----
XXXXXXXX---XXXXXXXXXXXXXXXXX
