----------------------------
----------------------------
----------------------------
--------SSSS-----------SS---
---S------------------------
----------------------------
----------------------------
----------------------------
----------------------------
---------<>------------Q----
---------[]-----------------
---------[]-----------------
----E----[]-----------------
-XXXXXXXXXXXXXX----XX--XXXXX
