----------------------------
----------------------------
----------------------------
---------SSSQS--------------
----------------------------
----------------------------
----------------------------
--------S---------Q---SS----
----------------------------
----------------------------
----------------------------
---------XX----<>-----------
---EE---XXX----[]-----------
XXXXXXXXXXX--XXXXXXXXXXXXXXX
