----------------------------
----------------------------
----------------------------
--------------------Q---S---
---Q---SSSS-----------------
----------------------------
--------------SSQS----------
----------------------------
----------------------------
--------?-------------------
----------------------------
-----------------<>---------
-----------------[]---E-----
---XXXXXXXX--XXXXXXXXXXXXXXX
