----------------------------
----------------------------
----------------------------
-----------Q----------------
------------------------S---
----------------SQQS--------
----------------------------
----------------------------
----------------------------
-----------------SSSS-------
---<>-----------------------
---[]-----------------------
---[]------------------E----
---[]---XXXXXXX---XXXXXXXXXX
