----------------------------
----------------------------
----------------------------
------------------Q---------
---S---SSSS-----------------
--------------?-------------
----------------------------
----------------------------
----------------------------
----------------------------
----------------------<>----
----------------------[]----
------E------X--------[]----
-XXXXXXXXXXXXXXXXX--XXXXXXXX
