----------------------------
----------------------------
----------------------------
------------SS--------------
----------------------------
-----------------SSSSQS-----
----------------------------
---S----Q-------------------
-------------?--------------
----------------------------
----------------------------
--------------------<>------
-------------E-E----[]------
XXXX---XXXXXXXXXXXXXXXXXX---
