----------------------------
----------------------------
----------------------------
------------S---------------
----------------------------
-----------------SSSS-------
----------------------------
----------Q-----------------
----------------------------
----------------------------
----------------------XX----
---------------------XXX----
---<>------E-E------XXXX----
---[]---XXXXXXXXXXXXXXXX----
