----------------------------
----------------------------
----------------------------
-----------Q----------------
----------------------------
----------------------------
---S------------------------
----------SSQS-----SSSS-----
----------------------------
----------------------------
----------------------------
--------------------<>------
---X---E-E----------[]------
XXXXXXXXXXXXXX---XXXXXXXXXXX
