----------------------------
----------------------------
----------------------------
----------------------------
----Q-----------------------
----------------------------
------------------------S---
---------SSS----------------
---?------------------------
----------------------------
------------------------X---
---------<>------------XX---
---------[]----E------XXX---
---XXXXXXXXXXXXXXXXXXXXXX---
