----------------------------
----------------------------
----------------------------
----------------------------
----------------------------
----------------------------
----------------------------
----------------SSSS---S----
----Q-----------------------
-----------X----------------
----------XX----------------
---------XXX------<>--------
----E---XXXX------[]--------
XXXXXXXXXXXXXX----[]---XXXXX
