----------------------------
----------------------------
----------------------------
----------------------------
-----------Q----------S-----
----------------------------
----SSQS--------------------
----------------------------
-------------------SSSS-----
----------------------------
----------------------------
-----<>---------------------
-----[]-----E-E-------------
XXXXXXXXXXXXXXXXXXXX---XXXXX
