----------------------------
----------------------------
----------------------------
----------------------------
----------------------------
------------------Q---------
----------------------------
----------SSSS--------S-----
----------------------------
----------------------------
-----------------<>---------
-----------------[]---------
---------E---X---[]---------
XXXXXXXXXXXXXXXXXXXXXXXXXXXX
