----------------------------
----------------------------
----------------------------
----------------------------
-----------------S----------
----------------------------
----SSSQS---Q---------------
----------------------------
----------------SS----------
----------------------------
----------------------------
----------------------<>----
----E-E---EE----X-----[]----
XXXXXXXXXXXXXXXXXXXXXXXXXXXX
