----------------------------
----------------------------
----------------------------
-----------------------Q----
-----------SS---------------
----------------------------
---SSQS---------------------
----------------S-----------
----------------------------
----------------------------
--------------------XX------
<>-----------------XXX---<>-
[]---E-E----------XXXX---[]-
XXXXXXXXXXXXXXXXXXXXXX---[]-
