----------------------------
----------------------------
----------------------------
---------------------SSSS---
----------------------------
-------SSQS-----------------
----------------------------
----------------------------
----------------------------
-----------S---Q------------
----------------------------
------<>--------------------
E-E---[]-------------EE-----
XXXXXXXXXXXXX---XXXXXXXXXXXX
