----------------------------
----------------------------
----------------------------
----------------------------
----------------------------
----------------------------
------------------S---------
--------------Q-------------
----SSSS--------------------
----------------------<>----
----------------------[]----
----------------------[]----
--------X---E-E-------[]----
XXXXXXXXXXXXXXXXXXX--XXXXXXX
