----------------------------
----------------------------
----------------------------
--------SSS-----------Q-----
----------------------------
----------------------------
----------------------------
---------------?---SSQS-----
-------S--------------------
----------------------------
----------------------------
-----------------<>---------
-----E-E---------[]-----X---
-XXXXXXXXXXXXX---[]--XXXXXXX
