----------------------------
----------------------------
----------------------------
----S-------------------Q---
----------------------------
----------------------------
----------------------------
----------------------------
----------SSSS-----SSQS-----
----------------------------
------X---------------------
-----XX---------------------
----XXX----------------E----
XXXXXXXXXX---<>---XXXXXXXXXX
