----------------------------
----------------------------
----------------------------
----------------S-----------
--------SSQS----------------
----------------------------
----------------------------
---------------Q------------
-----SSSS-------------------
----------------------------
----------------------------
------------<>--------------
-------X----[]-------E------
----XXXXXXXXXXXXXXXXXXXXXXXX
