----------------------------
----------------------------
----------------------------
-------SSSS-----------------
---------------Q------?-----
----------------------------
----------------------------
----S-----------------------
----------------------------
----------------------------
----------------------------
------------------<>--------
------E-E----X----[]--------
---XXXXXXXXXXXXXXXXXXXXXXX--
