----------------------------
----------------------------
----------------------------
----------------------------
----------------------------
--------------S----SSSS-----
-------?--------------------
----------------------------
---Q------------------------
-----------<>---SSQS--------
-----------[]-------------XX
-----------[]------------XXX
-----E-E---[]-----------XXXX
XXXXXXXXXXXXXXXXXXX--XXXXXXX
