----------------------------
----------------------------
----------------------------
--------------------Q-------
-------------SSSS-----------
----------------------------
----------------------------
----------------------------
---------SSQS---S-----------
-----------------------<>---
-----------------------[]---
-----------------------[]---
------E-E-------X------[]---
---XXXXXXXXXX--XXXXXXXXXXXXX
