----------------------------
----------------------------
----------------------------
-------------------SSSSQS---
---------------S------------
----------------------------
----------------------------
--------Q--------------SS---
----------------------------
----------------------------
----------------------------
------<>--------------------
------[]-------X------E-E---
---XXXXXXXXXXXXXXXXXXXXXXXXX
