----------------------------
----------------------------
----------------------------
--------SSQS---Q------------
---S---------------SSSS-----
----------------------------
----------------------------
-----------?----------------
----------------------------
----------------------------
----XX----------------------
---XXX------------<>--------
--XXXX------E-----[]---X----
XXXXXXXXXXXXXXXXXXXXXXXXXXXX
