----------------------------
----------------------------
----------------------------
-------------------SSSSS----
----------------------------
----------------------------
----------------------------
---------------------Q------
-------S--------------------
----------------------------
----------------------------
---------------<>-----------
---E-E---------[]-------X---
XXXXXXXXXXX--XXXXXXXXXXXXXXX
