----------------------------
----------------------------
----------------------------
-----------Q----------------
----------------SSQS--------
----------------------------
----SSSS--------------------
----------------------------
----------------------------
-------------<>-------S-----
-------------[]-------------
-------------[]-------------
--------E----[]-------------
XXXXXXXXXXXXXXXXXX---XXXXXXX
