----------------------------
----------------------------
----------------------------
---SSQS-----S---------------
----------------------------
----------------------------
----------------------------
---Q------------------------
----------------------------
-------SSSS-----------------
-------------------X--------
------------------XX---<>---
---E-------------XXX---[]---
XXXXXXX---XXXXXXXXXX---[]---
