----------------------------
----------------------------
----------------------------
----------------------------
----------------------------
--------Q-------SSQS----S---
----------------------------
----------------------------
----------------------------
--------------SSS-----------
-----------------------XX---
----<>----------------XXX---
----[]-----E---------XXXX---
XXXXXXXXXXXXXX---XXXXXXXXXXX
