----------------------------
----------------------------
----------------------------
----------------------------
----------------------------
--------------------Q-------
----SSSSQS------------------
--------------S-------------
----------------------------
----------------------------
---<>-----------------------
---[]-------XX--X-----------
---[]------XXX--XX----E-----
XXXX]XXXXXXXXX--XXXXXXXXXX--
