----------------------------
----------------------------
----------------------------
----S-----SSSSS-------------
----------------------------
----------------------------
------------------Q---------
----------------------------
----------------------------
----------------------------
-------------------<>-------
-------------------[]-------
----------E-E------[]-------
XXX--XXXXXXXXXXX---[]---X---
