----------------------------
----------------------------
----------------------------
-------------SSSS-----------
----------------------------
----------------------------
----------------------------
-----------Q-----------?----
-----------------S----------
----------------------------
----------------------------
----------------------------
---<>-------E----X----------
---[]---XXXXXXXXXXXXXXXXXXXX
