----------------------------
----------------------------
----------------------------
----------------------------
-------Q--------------------
----------------------------
----------------SSSS---S----
----------------------------
----SSQS--------------------
----------------------------
----------------------------
-----------<>---------------
-----------[]---E-E-----X---
XXX--XXXXXXXXXXXXXXXXXXXXXXX
