----------------------------
----------------------------
----------------------------
----------SS----SSSSQS------
----------------------------
----------------------------
----------------------------
----------------------------
--------Q-------------------
-----------------S----------
----------------------------
------------<>--------------
---E-E------[]-------X------
XXXXXXXXX---[]---XXXXXXXXXXX
