----------------------------
----------------------------
----------------------------
-----S----------------------
----------------------------
-------------------SSSSQS---
----------------------------
-------------Q--------------
-------SS-------------------
--------------------<>------
--------------------[]------
--------------------[]------
-------EE-E-----X---[]------
XXXXXXXXXXXXXXXXXXXXXXXXXXXX
