----------------------------
----------------------------
----------------------------
----------Q---S-------------
----------------------------
----------------------------
---SS-------------SSSSQS----
----------------------------
----------------------------
----------------------------
------------------<>--------
------------------[]--------
----E-------------[]-E-E----
XXXXXXXX---XXXXXXXXXXXXXXXXX
