----------------------------
----------------------------
----------------------------
---S------------------------
----------------------------
----------------------------
---------------------SSSS---
-----------------Q----------
----------------------------
----------------------------
------------------------<>--
------------------------[]--
---E-E-------------X----[]-E
XXXXXXXXXXXXX--XXXXXXXXXXXXX
