----------------------------
----------------------------
----------------------------
-----------------------S----
-----------------Q----------
----------------------------
-----SSSS-------------------
----------------------------
----------------------------
------------XX--------------
-----------XXX---<>---------
----------XXXX---[]---------
---------XXXXX---[]-E-------
---XXXXXXXXXXXXXXXXXXXXXXXXX
