----------------------------
----------------------------
----------------------------
----------------------------
--------------------SSSS----
---SQQS---------------------
----------------------------
--------------Q-------------
----------------------------
---------<>------------S----
---------[]-----------------
---------[]-----------------
---X-----[]-----E-----------
XXXXXXXXXXXXXXXXXXXX--XXXXXX
