----------------------------
----------------------------
----------------------------
---------------Q------------
----------------------------
-------S--------------------
---------------------SSSS---
--------------SSQS----------
----------------------------
----------------------------
----------------------------
---------<>-----------------
---E-----[]--------X--------
XXXXXXXXXXXXXX--XXXXXXXXX---
