----------------------------
----------------------------
----------------------------
-------------------Q--------
-----------SSSS-------------
----SSQS--------------------
----------------------------
-----------------------S----
----------------------------
----------------------------
-------------X--------------
------------XX---<>---------
-----------XXX---[]------E--
XXXXXXXXXXXXXX---[]---XXXXXX
