----------------------------
----------------------------
----------------------------
-------------SSQS----?------
-------S--------------------
----------------------------
----------------------------
-------------------Q--------
--------SSSS----------------
----------------------------
----------------------------
----X---------------<>------
---XX------E--------[]------
XXXXX---XXXXXXX--XXXXXXXXXXX
