----------------------------
----------------------------
----------------------------
--------------------S-------
------------SSSS------------
----------------------------
----------------------------
----------------------------
--------------Q-------------
-------------------X--------
------------------XX---<>---
-----------------XXX---[]---
-----E-E---X----XXXX---[]---
XXXXXXXXXXXXXXXXXXXX---[]---
