----------------------------
----------------------------
----------------------------
-----------SSSS-------------
------Q-------------?-------
----------------------------
----------------------------
----------------------------
----------------S-----------
---<>---SSQS----------------
---[]-----------------------
---[]-----------------------
---[]-------------E-E-------
XXXXXX---XXX--XXXXXXXXXXXXXX
