----------------------------
----------------------------
----------------------------
------------SSSSQS----------
----------------------------
-----------------------SS---
----------------------------
----------Q-----------------
----------------------------
-----S----------------------
----------------------------
--------------<>------------
------E-E-----[]-------X----
---XXXXXXXXXXXXXXXXXXXXXXXXX
