----------------------------
----------------------------
----------------------------
----------------------------
--------S-------------------
------------SS--------------
----------------------------
-----------------------Q----
---SSSSQS-------------------
------------<>--------------
------------[]--------------
------------[]--------------
----E-E-----[]-----X--------
XXXXXXXXXXXXXXXXXXXXXXX---X-
