----------------------------
----------------------------
----------------------------
---SSQS---------------------
----------------------------
----------------------------
-----------------------S----
----Q------SSSS-------------
----------------------------
----------------------------
----------------------------
------<>--------------------
------[]---E-----------X----
XXXXXXXXXXXXXX---XXXXXXXXXXX
