----------------------------
----------------------------
----------------------------
-----SSSS------Q------------
----------------------------
----------------------------
----------------------------
----------------------------
--------SSQS----------------
----------------<>----S-----
----------------[]----------
----------------[]----------
---E-E----------[]----------
XXXXXXXXXX---XX-----XXXXXXXX
