----------------------------
----------------------------
----------------------------
----------------------------
---------SS-------------Q---
----------------------------
----------------------------
--------------SSSQS---------
------------------------S---
----------------------------
----------------------------
----XX-----------<>---------
---XXX-----E-----[]---------
XXXXXX--XXXXXXXXXXXXXXXXXXXX
