----------------------------
----------------------------
----------------------------
---Q---------SSQS-----------
----------------------------
----------------------------
----------------------------
-----------------------S----
-------SSSS-----------------
----------------<>----------
----------------[]----------
----------------[]----------
----X----E-E----[]----------
XXXXXXXXXXXXXXXXXXXXXX--XXXX
