----------------------------
----------------------------
----------------------------
----?-----------------------
--------------SSSS----------
---------Q-----------SSQS---
----------------------------
----------------------------
----S-----------------------
----------------------------
----------------------------
-----------------<>---------
----X----E-E-----[]---------
XXXXXXXXXXXXXXXXXXXXXX--XXXX
