----------------------------
------------------S---------
-E--------------------------
----------------------------
--------S?---E--------------
------------SSSQS-----------
----------------------------
------?S-EE-----------------
---Q-----[]---Q-------------
---------[]-----------------
-------XXXXSSS--------------
-------X-QQ-----------------
-<>-XXXX-------E----------X-
-[]-XXXXXXXXXXXXXXXXXX--XXXX
