----------------------------
----------------------------
-----------------E----------
----------------------------
----------------S?S---------
--------S-------------------
--<>-------------S----?-----
--[]------------------------
-XXXX-----QSS---------------
XXXXX-----------------------
#####-------Q---------------
---------------XX---SQ------
-X-E------XXX--XX------EE---
XXXXXXXXXXXXXXXXXX---XXXXXXX
