----------------------------
-----X-XX-------------------
-----XXXX----XXX------------
-----###X--XXXXX------------
-S-------#######Q-----------
--------------------S-------
-?SQ------------------------
----------------------------
------------------------S---
----------------QSSS?-------
-----E---<>-----------------
---------[]-----------------
-----EE--[]---------XXXXX---
XXXXXXXXXXXXXX--XXXXXXXXXXXX
