----------------------------
-<>--------S?S--------------
-[]-------------------------
------------XXXX------------
-----------E####--SQSS------
------QQ--------------------
---------------S---------?--
----------------------------
------------E---------------
--------XXXXXX--------S-----
--------######-----<>-------
-----XXX-----------[]-------
--EE-XXX-XX-XXX--X-[]----E--
XXXXXXXXXXXXXXX--XXXXXXXXXXX
