----------------------------
-----------S-------?S-S?----
-QQSSQ----------------------
---------------S------------
----------------------------
---XX------------Q----------
---XX------------------<>---
---XX-------------E----[]-X-
-----------------------XXXXX
------------------------####
----------------------------
----SSS-----------XX--------
------------------XX-EE---E-
XXXXXXXXXXXXX--XXXXXXXXXXXXX
