----------------------------
---------SS?----------------
----------------------------
----------------------------
------------------------Q---
----------------------------
--------------Q-------------
-------------------------?S-
---------QSS----------------
-----------------------SQ---
-----E----------------------
-------------<>-------------
-EE----XX----[]XX---XXXXX-X-
XXXX--XXXXXXXXXXXXXXXXXXX-XX
