----------------------------
--------------------SS?-----
----------------QS----------
----------------------------
-----?S----------<>---------
-----------------[]---------
-----------------[]---------
-----------------[]---------
----E------------[]---------
----------------------------
---------------------SSQ----
-------------------X--------
-EEE-------XXX-----XXXXXX---
XXXXXXXXXXXXXXX-XXXXXXXXX--X
