----------------------------
-SQSS-----------------------
-----------Q--------Q-------
------------------------Q---
--------------S------S------
--------------------------E-
-----------------?S?--------
--S-----------------------S-
------<>--------------------
------[]--------------------
------[]---------S----------
------Q-----<>------EE-XXX--
---X-----X--[]-E---XXXXXXX--
X--XXXXXXXXXXXXXXXXXXXXXXXXX
