----------------------------
------S--------------E------
XXXX------------------------
####------------------------
----------------------------
-----------------SSQ---Q----
----------------------------
-----------<>---------------
-----------[]----S?S------S-
----------------------------
----------------SS?---------
---XXX----------[]----------
-E-XXX-XXXXX----[]----QS----
XXXXXXXXXXXXXXXXXXXXX----XXX
