----------------------------
-----------------------Q----
-----S-----Q---?SQ----------
----------------------------
----------------------------
------S--------SS-----------
---------------------E---S?-
----------------------------
--------S-------------------
-------------------S--------
-------------------------<>-
-----XXX--------QSSS---E-[]-
-X--XXXX--EE-XX----------[]-
XX--XXXXXXXXXXXXXXXXXXXXXXXX
