----------------------------
--------Q--------------<>---
-----------------------[]---
----------------------------
XXX-------------------------
###--------------S----------
---------------------SQS----
--------------------------E-
------XX---------SS------XXX
---Q--XX-----?S----------###
------[]E---------------S---
--X-E-[]----------S?--------
--XXXXXXX---X---------------
XXXXXXXXXXXXXXXXXX----XXXXXX
