----------------------------
-------S---S?-------S-------
--------------------------E-
----------------------------
---------------------Q------
--------SQS-----------------
----SS----------------------
----------------------------
----------------------------
----------------------------
---------------<>-----------
-------?SS--EE-[]-----------
-----------XXXXXXX-------XX-
XXXXXXXXXXXXXXXXXX--XXXX-XXX
