----------------------------
------SSQ-------------------
--------------------S?S-----
----S--<>-------------------
-------[]-S-----------------
-------[]-----------SSS-----
----Q-XXXXX-----------------
------XXXXX-----------------
---------XXX-X--------------
---------XXXXX--------------
-E-----QS#####--------------
----------------------------
---------------EE--XXXX-----
XXXXXX--XXXXXXXXXXXXXXX--XXX
