----------------------------
-----SS-----------QS?-------
--------SQQ-----------------
--------------------------S-
--------------S-------------
-------------------S-----E--
---------S------------------
------------E-----SS--------
----------------------------
---?S------------Q----Q-----
------------------------XX--
----------------<>-----XXXX-
-EE----------E--[]-----XXXX-
XXXXX--XXXXXXXXXXXXXXXXXXXXX
