----------------------------
---S------S-----------------
-------------------Q--SQS---
---------------Q------------
---?SSSQQ-------------------
----------------------------
----------------------------
----------------------------
--------------------------E-
----------------S-----------
-------S?-------------------
-----------------<>-EE------
---X---X------XX-[]XXXXXXXX-
XXXX---XXXXXXXXXXXXXXXXXXXXX
