----------------------------
----------------------------
----------------SSS---------
---------------------?--S?S-
-----S----------------------
---------------Q------------
---SQ--------E--------------
----------------------------
---------QS-----------------
----------------<>----------
----------------[]----------
----------------[]-E-XX---X-
-----EE-------XXXXXXXXX--XX-
XXXXXXXXXXXX--XXXXXXXXXXXXXX
