----------------------------
---------------S?-----------
--------E---------------<>--
------------------------[]--
-------------------------#S-
-----Q-----------QSS-----#--
-?S----------------------#--
------------Q------------#XX
------------------S-XX---###
-SQS--------SSS-----XX------
--------------------XX------
---------------------<>-----
-EE----------------X-[]-XXX-
XXXXXXXXXXXXXXX--XXXXXXXXXXX
