----------------------------
--------------------Q-------
--------------------------E-
---?------------------------
-----------------------S?S--
------------------SSS-------
---------SQQ----------------
----------------------------
---S---------XXXX-----------
-------------XXXX-----------
--------------###?----------
--------SQS-----------[]----
-XXX-<>-----X----X--E-[]-E--
XXXX-[]-XXXXXXX--XXXXXXXXXXX
