----------------------------
---------------------?SSQS--
----------------------------
----------------------------
----Q-------------------S---
----------------------------
----------S-----------------
--------------------------S-
--E--------SS?--------------
----------------------------
-------XX-------------------
-------XXXX------<>---------
-------XXXX---X--[]------EE-
XXXXXXXXXXX--XXXXXXXXXXXXXXX
