----------------------------
--------------SS------------
----------------------------
---S----------------------Q-
----------------------------
----------------------------
---------------X------------
----E----------XXXXX--------
-------------QS######--?S?--
--SSSQ----------------------
----------------------------
-----------XX-------S----<>-
-E--------XXX-XXXX-------[]-
XXXXXXXXXXXXXXXXXX---XXXXXXX
