----------------------------
-----QQS--------------------
-----------------Q-----SS?--
-SQ--------Q----------------
--------------?SS-----------
----------------------------
----------------------------
----------------------------
-S--------------S-----------
-----------E--------------S-
-----------------------<>---
-------X------------XX-[]---
-EE----X--------X---XXXXXXX-
XXXXXXXXXXX--XX-XXXXXXXXXXXX
