----------------------------
---XXXX-----S?S-------------
---XXXXXXX--------E---------
--S#######------------------
------------------------?---
-------------Q--------------
----------------------------
----------------------------
--------QSQ-----------------
-----------------S------Q---
--------------------------S-
----------SS------<>--E-----
-X-----EE---------[]-XXXXX--
XX-XXXXXXXXXXXX---[]-XXXXXXX
