----------------------------
-----------------------QS?--
----------------------------
----------E-----------Q-----
-SQ---------------S---------
----------------------------
--------------XX------------
---XXX------XXXX-----S------
---###?SS---XXXX------------
-----------?####Q----<>-----
---------------------[]-----
---------------------[]-----
------XXX--------EE--[]--X--
XXX---XXXXXXXXXXXXXXXXXXXXXX
