----------------------------
-----Q--------------SSS-----
----------------S-------E---
--S------SQS----------XXXXXX
----------------------######
-----------------X----------
-----------------X---S?S----
-------S---------X----------
-------------E---X----------
-----------------X----------
---X---Q---------X----------
---X------<>-?---XX---------
-XXX-EE---[]----XXXX--------
XXXXXXXXXXXXXXXXXXXX---XXXXX
