----------------------------
--------------<>----------S-
--Q-----------[]--S?S-------
--------------[]------------
---------------Q-------S----
-------S--QSQ-------------E-
---E------------SSS---------
----------------------------
-----------------?-------S--
----------------------------
-----S----------------------
----------<>-------XXXX-----
-------EE-[]-------XXXX---X-
XXXXXXXXXXXXX---XXXXXXXXXXXX
