----------------------------
----------S?SS--------------
----------------------------
-QSQQ-----------------------
-------------SS-------------
----------------------------
--------E-------------------
-<>-------------------------
-[]-------------------------
--?-------------------------
------------XX--------------
------------XX--------------
--XXXX--XX--XXX----EE----XX-
XXXXXX--XXXXXXXXXXXXXXXXXXXX
