----------------------------
----------------------------
------QS--------------------
-----------------S----------
--------S-------------S-----
-Q--------------------------
---------------------SQ-----
----------------------------
---<>------------S?S--------
---[]--------SSS------------
----Q-----------------------
----------------------------
--E-EE----XXX-----XXX--XXXX-
XXXXXXXXXXXXXXXXXXXXX--XXXXX
