----------------------------
----------------------------
--------------S?---S--------
-XXXXX-------------------Q--
X#####<>--------------------
##----[]---?SS----S---------
------[]--------------------
-------SS-------------------
-------------------S--------
----------------------------
----<>-----------E----------
----[]---------------QSQ----
-XXXXXX---XX-XXXX-EE--------
XXXXXXXXXXXX-XXXXXXXXXXX--XX
