----------------------------
---------S------------------
-------------E--------------
----------------------------
-S------------<>------------
-------SQS----[]--S---------
--------------[]------------
--Q----------XXXXX---Q------
-------------#####----------
------------------------X---
------------?-----Q----XX---
-----SS?S------------E-XX---
------------E---X--XXXXXXXX-
XXXXXXXXXXXXXXXXX--XXXXXXXXX
