----------------------------
-------------QSS-<>---------
-?S--------------[]---------
----------------------Q-----
----------------------------
----------------------------
----------S-----------------
----------------------------
--------------------------E-
-S?------SS-----------------
----------------------------
---X----E--------SQ--[]-----
---X-XXXXXXX---------[]-----
XXXXXXXXXXXXX--XXXXXXXXXXXXX
