----------------------------
-----------------SS---------
----------------------------
-----E------QS----SS?-------
---------Q------------------
----------------------------
----------------------------
------------------------?SQ-
----------------------------
----------------------------
----------------------------
--X------------------<>-----
--X--XX-----EE-XXXXX-[]XXXX-
X-XXXXX--XXXXXXXXXXXXXXXXXXX
