----------------------------
-----------------------S----
----------S-----------------
------------------------?---
------<>-Q------------------
------[]--------------------
--------S----------QSS---S--
----SQ----------------------
------------------E---------
-------------------------Q--
-----------S?S--------------
-------X----------X-X----[]-
--E-X--X----EE-XXXXXXXX--[]-
XXXXX--XXXXXXXXXXXXXXXXXXXXX
