----------------------------
-----------S----QQSSSS------
XX--------------------------
###SQ-----------------------
--------------------------S-
-----E----------------------
--------------S--?----------
----SS?S--------------------
---------XX-------<>--------
----E--Q-XX-------[]--------
---------XXXX-----[]--------
---------####-----[]-X------
-XX---E----------XXXXX---XX-
XXXXXXXXX---XXXXXXXXXXXXXXXX
