----------------------------
----------------------------
-----------Q---------Q----S-
----------------------------
----------------------------
-SS--S----------------------
-----------------E----?S----
-X---SQS--------------------
-XX-------------------------
-XX-S?-----E--------------S-
-XX--------------------QQ---
-XX-----------------<>------
-XX----XXXX---------[]--EE--
XXX--XXXXXXXXXXXXXXXXXXXXXXX
