----------------------------
--------------SSS-----------
------E---------------------
----------------------------
-----?S---------------------
----------------------------
----------S---S-------------
-QSSQQ----------------------
--------------Q-------------
--------S-------------------
---------------------X------
----------S?---<>--XXX------
----EE---------[]--XXXXXXX--
XXXXXXXXXXX--XXXXXXXXXXXXXXX
