----------------------------
-------------------SQSS-----
--------------------------S-
---XX-----------------------
-E###-------?---------------
----------------------------
----------------------------
-------------Q--------------
---------------------E------
-----<>---------------------
-----[]-X---------XX--------
-----[]-XXX-SS?S-XXX--------
-----[]X###------XXX----E---
XXXXXXXX---XX-XXXXXX-XXXXXXX
