----------------------------
---------------S----Q---S?S-
----------------------------
----?------QSS--------------
-----------------SSQ--------
-----------SS---------------
-E--------------------------
-----------------XXXXXX-----
-----------------######-----
----------------------------
----------------------------
---XX---X-----S-----<>------
-E-XX--XXXXX----XXX-[]---EE-
XXXXX--XXXXXXXXXXXXXXXXXXXXX
