----------------------------
-------Q----SQS-------------
----------------------------
--------------SS-------S----
----E-----------------------
----------------------------
--X-------------------------
XXX-------<>----------------
###S------[]------S?--------
----------[]----------Q---X-
-----------Q------?S------X-
----------------------<>--X-
---XXXXXX--S-------EE-[]-XX-
XXXXXXXXX----XXXXXXXXXXXXXXX
