----------------------------
--<>------------SQQSS-------
--[]------------------------
--[]-----?------------------
---S------------------------
-----------<>----E----S-----
-----------[]---------------
----------XXXXX----------XXX
------S---#####-Q--------###
----------------------------
--------------------------S-
---------------S?SS---------
--EE----XXX-XX--------XXXX--
XXXXXXXXXXX-XX--XXXXXXXXXXXX
