----------------------------
-S?SSQ----QS--S-------------
-------------------Q------S-
----------------------------
--------?SS-----------------
----------------------E-----
------------------------E---
----------XXX---------S-----
----------####-----Q--------
----------------------------
------------------S---------
----<>----------------------
-XX-[]-XXXX--EE-----XX------
XXXXXXXXXXX-XXXXXX--XXXXXXXX
