----------------------------
-----S------------------S---
----------------------------
--------------S?SSSS--------
----------------------------
------------XX--------------
-----XXX---E###-------------
-----XXX--------------------
-----###--------------------
--<>-----------QSQ----?-----
--[]------------------------
-XXX----------------------Q-
-XXX---------------EE--E----
XXXXXX--XXXXXXXXXXXXXXXXXXXX
