----------------------------
XX------------------QS?-----
####---------------------Q--
---------------?S-----------
-----SQ-----------------<>--
----------------S-------[]--
----------E-------------[]--
------------------------[]--
-------------------------SS-
------------------S---------
--Q-----------SS------------
--------X--------------<>-S-
-EE----XXXXXX--XX-XX---[]---
XXXXXXXXXXXXXXXXX-XX-XXXXXXX
