----------------------------
------------SQS?----------Q-
----------------------E-----
-----------S----------------
----------------------------
------------------Q---------
-SS-----------S-----Q----E--
----------------------------
------------------S---------
--------<>---SS-------------
--------[]-------?S---------
------XXXXX-----------------
------XXX-XXX---XX---X-EE---
XXXXXXXXX-XXX--XXXXXXXXXXX-X
