----------------------------
-----------S----------------
----------------------------
--SQ------------------------
--------S-------------------
----------------------S?----
---QQ-----------------------
--------S--------------QSS--
----------------------------
----------?SSS--------------
-----------------XX---------
-----<>--E------XXX--X------
--EE-[]---------XXX-XX-E----
XXXXXXXXXXXXXX--XXXXXXXXXXXX
