----------------------------
-----------------<>---------
--Q--------------[]----Q----
-----------------[]SQS------
--S---------XXXXXXX---------
------------####XXX---------
--------------------------S-
----------------------------
------E--------S?SS-----E---
---------------------SSSSS--
----?-----------------------
-XX-------------------------
-XXXX-----XX-------------EE-
XXXXXXXXXXXX----XXXXXXXXXXXX
