----------------------------
----------------------------
---------QS-----------------
--------------Q--S----------
------S----------------?S?--
---------E------------------
------------------S---------
-------------S--------------
----------------------------
----------------------------
------------<>-----SSSQ-----
-XX--X------[]--------------
-XXXXX-----XXXX----------EE-
XXXXXXXXXXXXXXX--XXXXXXXXXXX
