----------------------------
-------------------Q--------
-----------------------?S---
------S---------------------
---Q------------------------
----------------------------
-----------------------E----
-QSQ----SS------------------
------------------SS-S?-----
------------------------<>--
------------------------[]--
--XXXX------------------[]--
--XXXX--EE---E----XXX-------
XXXXXXXXXXXXXXXXXXXXXX---XXX
