----------------------------
---?S?----------------------
----------------Q-----------
-----E--S-------------------
---S------------------------
---------------S------------
-E--------------------------
XXX-------------S-----------
###------QQS----------------
---Q----------------QSSSSQ--
--------X-------------------
--------X-------S--------<>-
-E-XXXXXXXX--------------[]-
XXXXXXXXXXX--XXXXXXXXXXXXXXX
