----------------------------
--------------S-?-----------
--------------------S-------
----E---X-------------------
------XXX----------Q--------
------XXX-S-----------------
------XXX-------------------
----SS--SS-----------QQS----
-----------------Q----------
-------------E--------------
------------XXX-------------
-----S?SQ---XX-------<>-----
------------XXX------[]-XX--
XXXX----XXXXXXXXXXXXXXXXXXXX
