----------------------------
---S--E-----------EE------<>
-----------------XXXXX----[]
----------------E#####----[]
--SQSS--------------------S-
----------------------------
-QQ-------------------------
----------------------------
--S--------S---Q------------
----------------------------
----------------?SS?--------
-<>-------------------------
-[]-------X--X-----XXXXXXXX-
XXXX---XXXX--XXXXXXXXXXXXXXX
