----------------------------
----------<>----------------
----------[]----S-----------
----------XXX---------------
----------XXX--?S?-----QS---
-----------S----------------
-----------------------SQ---
----------------------------
-----S-----------------S----
--------------X----SSS------
--------------X-------------
--------------XX--------EE--
---E---XX-----XXXXX----XXXX-
XX---XXXXXXXXXXXXXX-XXXXXXXX
