----------------------------
---------?S-----S-----------
--------------------Q-----S-
------E-----E---------------
---------------------SQQSS?-
--------Q-----Q---S---------
-----------E----------------
----------SSS---------------
--------S-------------------
-----------S----------------
---------------Q------------
---XXXX---<>----------------
---XXXX---[]-XXXXXX-----EE--
XXXXXXXXX-XXXXXXXXX--XXXXXXX
