----------------------------
--------------SSS-----------
-Q-----S----Q---------------
----------------------------
------?SQS-----E------<>----
-----------------Q----[]----
----------S?----------#XXXXX
----------------------######
----------------------------
------S---------------------
----------------------------
----------<>----X-----------
---EE-XXX-[]X---XXXXX---E---
XXXXXXXXXXXXX--XXXXXXXXXXXXX
