----------------------------
----------------------S-----
----------------------------
----------S-----------------
----------------------------
-----Q---SQ-----------------
----------------------------
-S-------Q-----E--------QS--
-----------------SSS--------
--------------S?------E-----
------<>--------------------
--X---[]------------?S------
--X-XXXXX---XXXX-EE-----X---
XXXXXXXXX-XXXXXXXXXXX---XXXX
