----------------------------
-SQ------------?------------
--------------------S-------
--------S?S-----------------
---------------<>----E----Q-
---------------[]-----------
--------------XXX-----------
--------------XXX-----------
--------S-----S-----QSSS----
----------------------------
--------X-------------------
--------X-E-----------------
----EE--XXXXX--X-XXXX-------
XXXXXXXXXXXXXXXXXXXXXXXX--XX
