----------------------------
--S-------E--Q--------------
----------------------------
-------S?SSQQ----S----------
-------------------------XX-
---QSSS---S--------------XX-
-----------------------XXXXX
---------------?-------#####
-------------------Q--------
----------------------------
--------------S-------------
---------------------<>-----
-XXXX-XX-------EE----[]-X---
XXXXX-XXXX--XXXXXXXXXXXXXXXX
