----------------------------
---------E--QQ--------------
-SQ-------------------------
----------------------------
--------------QSS?----------
----S-----------------------
----------------------------
--?S------------------------
----------------------------
---------------------Q------
----------------E--------X--
--------<>-----------SS-XX--
--XXXXX-[]-XXX-EE-------XX--
XXXXXXXXXXXXXXXXXXXXX--XXXXX
