----------------------------
--Q---QQ--------E-----------
----------------------------
-------?S?------------------
----------------E-----------
----------------------------
---------------SS-----SS----
-SQS-----S---------------XXX
----------------X--------###
----------------X-----------
------E--------XX-----------
----XXXX-------XX-------<>--
----XXXX-------XX-------[]--
XXXXXXXXXX--XXXXXXXXXXXXXXXX
