----------------------------
------?S----------QSQ-------
---S---------E--------------
--------SS------------------
----------------------------
-----SS-XXX------------S?---
-------####-----------------
----------------------------
----------------------------
-----QQ---------------------
----------------------------
-------<>-----X-------------
--XXXX-[]---XXX--EE--XXX----
X-XXXXXXXXXXXXXXXXXXXXXXXXXX
