----------------------------
-----------------E----------
----------------------------
------Q-----------?S--------
--SS------------------------
----------------XXX---------
----------------XXX---------
------------S?--####--------
----------------------------
----------------------------
-------QQS--SSQ-------------
----------------XXX---<>----
---E-E-----X----XXX---[]----
XXXXXXXXXXXX--XXXXXXXXXXXXXX
