----------------------------
----------------------------
----------------------------
---QS-----------------------
------------?S--------------
-S?---------------Q---------
------SSS-------------------
----------------------------
----XXX-------<>-------SQ---
-E--XXX-------[]------------
----###-------[]------------
-------------XXXX-------X---
-EE-------XX-XXXX-----XXX---
XXXXXXXXXXXXXXXXX---XXXXXXXX
