----------------------------
XXXXXXX--?-----------QS?SQ--
#######---------------------
----------------------------
----------E-----------Q--XX-
---------------Q---------XXX
---S-------------S-----SQ###
----------------------------
--------S---------SS--------
--------------------------S-
----------------------------
-------<>--XX---------------
--E-EE-[]--XX------XXX------
XXXXXXXXXXXXX----XXXXXXXXXXX
