----------------------------
----------------------?---Q-
-----S?S-----EE-X-----------
-S----------XXXXXXX---------
------------#######---------
----------------------------
----SSS---------------------
---------<>-E-----QSQ-------
---------[]-----------------
----S----[]-----------------
----------------------------
------------<>--------------
--E--XX-----[]-XXX--X---XXX-
XXXXXXXXXXXXXXXXXXXXX---XXXX
