----------------------------
-----E-------?S-----S-------
----------------------------
----------S----XXX----------
-------------XXXXX----------
-------------#####SSSS?-----
----------------------------
-------------------<>-------
-----QSSQQ---------[]-------
------------------XXXX------
-S---------------Q####E-----
---XX--X--------------------
---XXXXX-EE--------E--------
X--XXXXXXXXXXXXXXXXXXXXXXXXX
