----------------------------
-SQS------------------------
------------------S?S-------
----------------------------
--S-------------------------
----Q---QQ---------?--------
XXX-------------------------
###--------E----------------
---SSS----------------------
----------------------------
------------------X---------
-XXX-----<>-------X---------
-XXX--EE-[]-------EE----XX--
XXXXXXXXXXXX--XXXXXXXXXXXX-X
