----------------------------
----------------------------
-------------------S--SS?---
---SS-----------------------
--------?SQQS----Q----------
----------------------------
----------------------------
-----------Q----------------
-------------------<>-S---E-
-------------------[]-------
-------------------[XSQ-----
--XX-EE------------[]-------
--XXXXXX--XX-------[]--X--E-
X-XXXXXXXXXX--XXXXXXXXXXXXXX
