----------------------------
--------------------Q-------
----------------------------
----<>----------------------
-Q--[]---?SQS?-E------------
----[]----------------------
----------------------S-----
------------S---------------
----SSSS-----------SQQ------
----------------------------
-S-----S----------S---------
-----------------------EE---
---XX-----E--X--XX--XXXXXX--
XXXXX--XXXXXXX--XXXXXXXXXXXX
