----------------------------
----------------------------
-E-----------------?S-------
--------S-------------------
----S?-----------QS---------
----------------------------
----------------SQ--------S-
--------------------<>------
---------------Q----[]------
---------SS--------XXXX-----
-------------------S--X---Q-
----------E----------XX-----
------X--XXXXXXX-----XX--EE-
XXXXXXX--XXXXXXXXXXXXXXXXXXX
