----------------------------
-SQSS--SS---------------Q---
----------<>--------------S-
----------[]----------------
----------[]----------------
----S-----E-----------------
-------S?SSS---E------------
----------------------------
----?-----------------------
----------------------------
-----------------X----------
-----------------X---<>-----
--------XXXXXX---XXX-[]--EE-
XX--XXXXXXXXXXXXXXXXXXXXXXXX
