----------------------------
-----------S--?--------Q----
----------------------------
-------------S-------<>-----
---------------------[]-----
---------------------S------
--SSSSQ---------------------
----------------------------
----------------------------
--------XX------------------
--------[]-QS---------------
--------[]-----XX------S?S--
-E-EE-XXXXX----XXX----------
XXXXXXXXXXXXXXXXXX--XXXXXXXX
