--------#-------------------
--------#XXXX---------------
--------#####---------------
--------------------------S-
-----------S----------------
-----------------------Q----
--S--SQSS------------E------
----------------------------
----S-----------------?SS?--
-------------Q--------------
-Q---<>-----------EE--------
-----[]----------XXXX-------
---XXXXXX-XX-----XXXXX------
XXXXXXXXX-XXXXXXXXXXXXXX---X
