----------------------------
---Q------------------------
-----?----------------------
----------------S-----------
------------------------S---
---S----XXXXXX--------------
--------######-----E-S?S----
----------------------------
----------QS----------------
----------------------SSSQ--
-------------------<>-------
--------------XX---[]-------
-XXXX---E-----XXXX-[]-E-XXX-
XXXXXXXXXXX---XXXX-XXXXXXXXX
