----------------------------
-----------------Q------SS--
---------------E------S-----
----------------------------
----------------------------
-----------------QQSQSS-----
------S------------------Q--
----------------------------
--------S----------?--------
------------XX--------------
------------XX-----S?S-<>---
------<>--XXXX-E-------[]---
-X----[]--XXXX----EE---[]-X-
XXXXXXXXXXXXXXXXXXXXX--XXXXX
