----------------------------
----------------------Q-----
----------------------------
-S---------------<>-E-------
----------?S-----[]--------X
-S--------------XXXX--SQQ###
---------QSQ---####E--------
----------------------------
---------S------------------
---SS?-------------------S--
---------Q-----X------------
------X--------X------------
---E-XX------XXX-XXXXXX-----
XXXXXXXXXXXXXXXX-XXXXXXXXXXX
