----------------------------
----------------------------
-----------------------<>---
----S------------------[]---
-----------------------[]---
-Q--------------QSQ--SS-----
------------?SS-------------
----------------------------
-------------------------S?-
----------------------------
-------------------------XX-
-<>---------------------XXX-
-[]-XX---EE-X--XX----E--XXX-
XXXXXX-XXXXXX--XXXXXXXXXXXXX
