----------------------------
--------<>-------------Q----
--------[]------------------
---------E------------------
------Q------QQSSSS---------
----S----?SQ-------------X--
-------S-----------------X--
-------------------------X--
------------------------XX--
------------S?-----XXXXXXX--
-------------------XXXXXXX--
-------------------#####[]--
-E----XXX--EE-----------[]--
XXX--XXXXXXXXXXXXXXXXXXXXXXX
