----------------------------
-Q--------------------<>----
----------------------[]-?S-
----------------------[]----
----------------------S-----
-----------------E--------E-
-------------S--------------
-------SSQ----------S-------
--QSS--------S?--------E----
----------------------XXX---
------------------S---X--Q--
---------------<>-----X-----
-XXX-------XXX-[]--XXXX-----
XXXXXXXXXXXXXXXXXXXXXXX--XXX
