----------------------------
----------SS-------------XXX
---E---------------------###
-----------------?SS?-------
----------------------------
-----------------------QS---
---S------------------------
--------------SQQ-----------
----------------------------
--------------S-------------
----------------------------
------------X-EE-X-<>-------
-------XXXX-XXXXXX-[]-------
XXXX--XXXXXXXXXXXXXXXXXXXXXX
