----------------------------
----------------------------
--------------------S-------
----------------------------
-------------QS----------S?-
----------------------------
-EE---S-----------------SSS-
XXXX------------------------
####------------------------
-------------------------E--
--------------------<>-Q----
--------?SQ---XXXX--[]------
-XXX----------XXXX--[]------
XXXXXXXXXX-XXXXXXXXXXXXXX--X
