----------------------------
----------------------------
-----?S---------------------
----------------------------
------------------------SSQ-
----------------------------
-X--------------------------
XX----------------QSS-------
###---S?--------------------
----------E-----------------
---<>-----------------------
---[]-----------------------
--XXXXXX-XXXXX-------EE-----
XXXXXXXX-XXXXXX--XXXXXXXXXXX
