----------------------------
----------------SQ----------
---------------------Q------
----------------------------
--------------------S?------
----------Q-----------------
-------S-------------E------
-----------------QS---------
---------?SS------------SSS-
---S------------------------
------------------X---------
--------------XX--X--X--<>--
--EE-------X--XXXXXXXX--[]--
XXXXXX--XXXXXXXXXXXXXX-XXXXX
