----------------------------
----------------------------
----------------------------
--------Q-----------SQS?S---
----------------------------
--E---?-----------------E---
XXXXX-----------------------
#####------------QSSS-------
----------------------------
--X---------------------S---
--X-------------------------
--X------------<>-----------
--X-----XXXXX--[]--XXXX---E-
XXX--XXXXXXXXXXXXXXXXXXXXXXX
