----------------------------
-E--------------------------
------------------------S---
-----Q--------------------E-
--------?SQ-----------------
-----------------SS---------
-----Q----------------------
----------------------------
----------------------------
----------QSS-----------S---
--------<>------------------
----X---[]-XX---S-----------
----XXX-[]XXX---------EE----
XXXXXXXXXXXXXXXXXXXXXXXXX--X
