----------------------------
---SQ---------------QS------
-------------------------SS-
--E--S----------S?----------
----------------------------
----------------------------
-------------S---Q----------
-<>---S---------------------
-[]X------------------------
XXXX------------------------
####E-----------------------
----------?S---XX-----------
--X-EE---------XXXXXXXXX--X-
XXXXXXXXXXXXXXXXXXXXXXXX--XX
