----------------------------
-----------S----QS--------E-
----------------------------
----------------------------
-----Q----------------------
----------------------------
----------------------------
---------XXXXX-SSS------?S?-
-----S---#####--------------
----------------------------
----SQ----------X-----<>----
----------------X-----[]----
---EE-------XXXXX----XXXX---
XXXXXXXXXXXXXXXXXXX--XXXXXXX
