----------------------------
-SSS-----------S------------
----------------------------
--------E-------------------
----------------------------
------XX--------------------
------XXX-------------------
------XXX--------X----------
---XXXX-S----SQ--####QQS?SS-
X-XXXXX----------S----------
#######---<>--<>----?---Q---
----------[]--[]------------
-----E-EE-[]--[]------------
XXXXXXXXXXXXXXXXXXXXXXXXXXXX
