----------------------------
-----------X--------?-------
-------<>-XX----------------
-------[]-XX----------------
------XXXXXX---------QSSS---
------####XX----------------
----S------------------E--Q-
---------------------S------
----------------------------
----------------------------
----------------------------
------X---------------SQ----
-EE---XX-S?S----------------
XXXXXXXX-----XXXXXX-XXXXXXXX
