----------------------------
---------SSQ----------------
---------------------SSS----
----------------------------
-------E-------?------------
------XXX-------------------
----QQ###-------------------
---------E-----------S?S----
----------------------------
------------------------<>--
-----XX-QS--------------[]--
-----XX----------------XXX--
-----XXXX-------------XXXX--
X--XXXXXXXXXXXXXXXXXXXXXXXXX
