----------------------------
----------------------------
----------------------S-----
--------------------------S-
-------------------S--------
----------------------------
-S------------SQSS?------Q--
-------Q---E----------------
-----------------------?S---
-----Q-----------E----------
---------S------------------
---<>-----------------------
---[]---XXXXX-XXX-XX---EE---
XXXXXX--XXXXXXXXXXXX-XXXXXXX
