----------------------------
------------E---------------
----S?------------------SS--
-XX-------------------------
XXX-----------Q-------------
###-------------------------
----------------------------
--QSSQ----------------------
---------S----------S-----S-
----------------------------
--------------------<>------
-------E------------[]------
------XXXX-X------XXXXXXX---
XXXXXXXXXX-XXXXXXXXXXXXXX--X
