----------------------------
----QSS?SS--S---------------
---------------------SQ-----
--------Q-------------------
----------------------------
------------------S---------
----------------------------
-S--------------------------
----------------------------
----------<>--E-?-----------
----------[]--------S-------
----------[]----XX-----EE---
----------[]--XXXX---XXXXX--
XXXXXXXXXXXXX-XXXX--XXXXXXXX
