----------------------------
----------S?S-?------S------
-----------------S----------
----------------------SSSQS-
----------------------------
--------Q----------------Q--
---------------------E------
----------------------------
----------------------------
--------------------------Q-
------XX--------------------
------XX-------------<>-----
-EE-XXXX---------XXX-[]-----
XXXXXXXXX--XXXXXXXXXXXXXXXXX
