----------------------------
----------------------------
-------------------<>-------
--------------S----[]-------
--E----------------[]-------
------------------XXXX------
-?S----------------###------
---------------SS?----------
--S-------------------SQSSQ-
-------Q--------------------
----------------------------
---------------------XXX----
----XXXX-EE----------XXX----
XXXXXXXXXXXXX--XXXXXXXXXXXXX
