----------------------------
------Q---------------------
-------------------SS?SSQ---
---------------E------------
--S---------?---------------
----------------------------
-------------Q--------------
------S---------------------
-------------------------XX-
-------------------------XX-
--------<>-------QS------XX-
--------[]----------------X-
--------XXXX-----XXX--EE--X-
XXXXX--XXXXXXXXXXXXXXXXXXXXX
