----------------------------
---<>-----------------------
---[]-----------------------
---------E-----SSS------S---
----------------------------
--------Q-------------------
----------------------------
----------------------------
XXX----------------------S--
###S?-----------------------
---------X-----------?SQS---
---------X---X--------------
--EE--XXXX---XXXXX--------E-
XXXXXXXXXXXXXXXXXX--XXXXXXXX
