----------------------------
----------------------X-----
----------------------X-----
--Q-----S-------------X-----
----------------------------
----SS?S------------------S-
------------------E---------
--------?-------------Q-----
-----------------E----------
----------------------SSQQS-
----------------------------
-------------------<>-------
-XXXX---EE--XXXX---[]---XXX-
XXXXXXXXXXXXXXXX--XXXXXXXXXX
