----------------------------
----------------------------
---------------E------------
-------XX-----XXX-----------
-S----XXX-----XXX-----------
------XXX-----?##E----------
-------S----S------------S--
----------------QSSS?-------
----<>----------------------
----[]XXX-------------------
---XXXXXX-?SSQ--------------
---#######------------------
--X-------E-----EE----------
XXXXXXXXXXXXXXXXXXXXX--XXXXX
