----------------------------
-----------<>---?---------S-
-----------[]---------------
-QQSSSS----[]---------------
----------------------------
----S---------------E-------
----------------------------
-------S?S------------QSQ---
----------------------------
----------------------------
----------------SQ----------
--E-------S-------------X---
-XXXX--XX---XX----------X---
XXXXXXXXX--XXXXXXXXXXXXXXXXX
