----------------------------
---------E----E---------S?S-
------------S---------------
----------------Q-----------
-Q--------------------------
----------------------------
---S--------S--------SQS----
-------------------Q--------
-----?----------------------
-X--------------SSSS--------
XX--------------------------
##-----------------E--X--<>-
---XXX----------XXXXXXX--[]-
XXXXXX---XXXXXX-XXXXXXXXXXXX
