----------------------------
-?S---------E----------QSS?-
----------------------------
-S--------------------------
----------------------------
----------------------------
-------------------------XX-
-------------------------XXX
-------------------------###
------------------SSQ-------
----------------------------
---X------------------<>----
---X--XXXX---------EE-[]----
XXXX-XXXXXX--XXXXXXXXXXXXXXX
